djentelmen	джентельмен
modýldenýi	модульденуі
sosıal-darvınızm	социал-дарвинизм
sosıal-demokratıalyq	социал-демократиялық
tushshylyq	тұщылық
búrokratızm	бюрократизм
ıarashaly	иарашалы
fakúltatıvtik	факультативтік
chobere	чобере
alonj	аллонж
poezıa	поэзия
stanısa	станица
sıtologıa	цитология
sychqannyń	сычқанның
teńdensıashyl	теңденцияшыл
bıseps	бицепс
ınterferensıasy	интерференциясы
ınternasıonalısti	интернационалисті
sýdıa-súmelek	судья-сүмелек
alohton	аллохтон
analgetıkter	анальгетиктер
chaıdam	чайдам
demarkasıalaý	демаркациялау
elektrkardıogram	электркардиограмма
barrıl	барриль
kompresor	компрессор
varıaqıalyq	вариақиялық
sýbvensıa	субвенция
vakýol	вакуоль
ıaqasyna	иақасына
chylaýyny	чылауыны
sýrdolımpıadalyq	сурдолимпиадалық
mıýaly	миуалы
ınformbúro	информбюро
aerobty	аэробты
ıodıttik	йодиттік
jebirshi	жэбірші
varág	варяг
razrádta	разрядта
býgel	бугель
okýpasıala	оккупацияла
radıstiń	радистің
ıatyqty	иатықты
trombosıt	тромбоцит
mochevına	мочевина
klasıka	классика
qarim	қарьім
repatrıant	репатриант
dıfferensıaqıa	дифференциақия
chaǵyldyq	чағылдық
avıasıasy	авиациясы
statısıkanyń	статистиканың
rokaıl	рокайль
trestiń	трестің
galısa	галлица
katolısızm	католицизм
belveder	бельведер
sımpozıým	симпозиум
fýnksıonaldylyq	функционалдылық
admıralısımýs	адмиралиссимус
ventılátor	вентилятор
saharaýı	сахарауи
sosıolog	социолог
modýlásıalyq	модуляциялық
ıntervensıalyq	интервенциялық
asfáltsyz	асфальтсыз
vındsórfıng	виндсёрфинг
dıfýzor	диффузор
barershi	барьерші
ıalabash	иалабаш
zıgomısetter	зигомицеттер
kýrerlik	курьерлік
qahýahana	қаһуахана
veb-saıt	вэб-сайт
metrdotel	метрдотель
pıktogram	пиктограмма
chıambý	чиамбу
ash-shafıǵııa	аш-шафиғийа
hajyryn	һажырын
elıpsograf	эллипсограф
mıtraleza	митральеза
chabaýyl	чабауыл
ekzısgensıaldyq	экзисгенциалдық
shahzande	шаһзанде
chylaýydyn	чылауыдын
yhtıary	ыхтиары
az-zahırııa	аз-захирийа
rasıonalıster	рационалистер
fotoetúd	фотоэтюд
áldegıdi	альдегиді
tehnısızm	техницизм
ıýrısdıksıasy	юрисдикциясы
dosent	доцент
flıgel	флигель
TKSh	ТКШ
panıslamıstik	панисламистік
ıýhıbbýhým	йухиббуһум
jýrnalısıkanyń	журналистиканың
ýnıversıada	универсиада
hokeı	хоккей
aerovokzal	аэровокзал
ısfahan	исфаһан
súrealıster	сюрреалистер
ıodmetrleý	йодметрлеу
statýetka	статуэтка
monopolızasıa	монополизация
kooperasıasy	кооперациясы
elektromobıl	электромобиль
aeroflot	аэрофлот
cháıisý	чәйісу
karbúratorly	карбюраторлы
terıtorıalyq	территориялық
týneldik	туннельдік
qoqim	қоқьім
kolmatırlegish	кольматирлегіш
skech	скетч
aeroponıka	аэропоника
beıýaz	бейуаз
makroetnıkalyq	макроэтникалық
proletarıattyq	пролетариаттық
sekresıa	секреция
melıorasıadaǵy	мелиорациядағы
vólttik	вольттік
manıakal	маниакал
hárdaıym	һәрдайым
marketıńilik	маркетингілік
dıalızator	диализатор
dempıńige	демпингіге
bıogeosenologıa	биогеоценология
novelashy	новеллашы
mahısti	махисті
ásireınternasıonalıs	әсіреинтернационалист
ındıkasıalaý	индикациялау
teleobektıv	телеобъектив
ekologıa	экология
reıýshke	рейушке
bıchara	бичара
ahdnama	аһднама
obektini	объектіні
ap-ımamııa	ап-имамийа
revanshıstiń	реваншистің
alopatrıa	аллопатрия
garmondat	гармоньдат
satýrasıalaý	сатурациялау
aspırasıa	аспирация
ıamǵýr	иамғур
gemogram	гемограмма
avıasıalyq	авиациялық
noıabr	ноябрь
doıyrla	доиырла
kasasıalyq	кассациялық
demarketıń	демаркетинг
kópetnosty	көпэтносты
egopsıhologıa	эгопсихология
ekvılıbrıstiń	эквилибристің
deformasıa	деформация
trıangýlásıalyq	триангуляциялық
feletondatý	фельетондату
ıalfandy	иалфанды
kondensasıa	конденсация
alkoloıdtyq	алколоидтық
adenokarsınoma	аденокарцинома
sensýalısti	сенсуалисті
torǵaıaýyz	торғайауыз
dekorasıa	декорация
sharıar	шәриар
padshahzadanyń	падшаһзаданың
ıashunurǵa	иашұнұрға
sýhanchın	суханчин
ýgro-fın	угро-финн
gastrosel	гастроцель
kúvet	кювет
hámsal	һәмсал
voklúz	воклюз
ventıl	вентиль
mıkrososıologıa	микросоциология
týfıt	туффит
bechenek	беченек
batalóny	батальоны
modýlásıalaý	модуляциялау
zúrrıat	зүрриат
relátıvti	релятивті
ıańrady	иаңрады
sýmochka	сумочка
charqat	чарқат
álfa-spektrometr	альфа-спектрометр
gemosıtoblast	гемоцитобласт
velárlan	велярлан
ekstraaktıvti	экстраактивті
damola	дамолла
chahshady	чахшады
okýpasıalan	оккупациялан
bınahaıat	бинаһайат
aprobasıalaý	апробациялау
lısenzıar	лицензиар
taqchaq	тақчақ
sentımentalısik	сентименталистік
komentator	комментатор
qyıýasyz	қыйуасыз
ashkarah	ашкараһ
pýrıs	пурист
ımperıalızm	империализм
ıarıldı	иарилди
makrosemıa	макросемья
ıatǵashuq	иатғашұқ
ınkonel	инконель
brýsell	бруцелл
búdjeti	бюджеті
birinch	бірінч
kóılek	көилек
ınovasıasy	инновациясы
mýsondar	муссондар
chópteý	чөптеу
konfısýrasıa	конфицурация
dıametrlik	диаметрлік
almaurq	алмаұрьқ
ahadny	аһадны
konsentrasıasy	концентрациясы
razrádtik	разрядтық
aparel	аппарель
kediktený	кэдіктену
ıaýlarmyn	иаулармын
ratıfıkasıalaý	ратификациялау
mılıtarıster	милитаристер
materıaldarynyń	материалдарының
qachyshdy	қачышды
akompanıator	аккомпаниатор
avıasıa	авиация
desımetrleý	дециметрлеу
qashirym	қашьірым
múltfılm	мультфильм
hemosorbsıa	хемосорбция
aeroklýb	аэроклуб
medalsiz	медальсіз
gaýhardaı	гауһардай
arıstotel	аристотель
JShBJ	ЖШБЖ
kúlmınasıalyq	кульминациялық
perseverasıa	персеверация
últrakárlen	ультракәрлен
kúlkilápchin	күлкіләпчін
akýmýlásıasy	аккумуляциясы
súrveıer	сюрвейер
miskerchilik	міскерчілік
glıosıtter	глиоциттер
shaıaıaq	шайаяқ
referensıa	референция
jahildik	жәһілдік
materıalıstiń	материалистің
eýrooblıgasıa	еурооблигация
baharaq	баһарақ
marketıń	маркетинг
leıborısik	лейбористік
bıostımýlátor	биостимулятор
antofeın	антофеин
leksıka-gramatıkalyq	лексика-грамматикалық
osılografıa	осциллография
kazeınogen	казеиноген
separasıa	сепарация
tirsıt	тьірсит
adaptasıalan	адаптациялан
eıdetıkalyq	эйдетикалық
komısarlarynyń	комиссарларының
kóchede	көчеде
taqııamatǵacha	тақйиаматғача
fılmder	фильмдер
artıkýlásıa	артикуляция
qalaqcha	қалақча
rejıserlik	режиссерлік
lınogravúra	линогравюра
polovester	половецтер
trıýmvırat	триумвират
ýchaskesin	учаскесін
merıdıan	меридиан
fonogram	фонограмма
modeler	модельер
máýlána	мәуляна
hámısha	һәмишә
klassıfıkasıa	классификация
achyǵlanyb	ачығланыб
qychqyr	қычқыр
redýksıa	редукция
elıpsıs	эллипсис
bıajal	биажал
ıntonasıa	интонация
bıhtar	биһтар
HShB	ХШБ
ıaqyldy	иақылды
búdjettiń	бюджеттің
fólklor	фольклор
epızod	эпизод
chyqǵanda	чықғанда
júrekırek	жүрекйрек
chatyrdaǵan	чатырдаған
vakým-shómish	вакуум-шөміш
chyqqýdek	чыққудек
aneksıa	аннексия
gastroenterologıa	гастроэнтерология
qudiret	құдырет
farııadra	фарийадра
prosenoz	проценоз
prezıdıým	президиум
evolúsıalyq	эволюциялық
epıfenomen	эпифеномен
sesıasy	сессиясы
allahý	аллаһу
ásireınternasıonalıstiń	әсіреинтернационалистің
edýteınment	эдутейнмент
púls	пульс
mısıa	миссия
shlúz	шлюз
bııapan	бийапан
ametıster	аметистер
dızel	дизель
valvasıa	вальвация
modıfıkasıalyq	модификациялық
taıammom	тайаммом
semányń	семьяның
adsorbsıa	адсорбция
ekstrýzıa	экструзия
ıashyqty	иашықты
shahızada	шаһизада
ekspromt	экспромт
gıpostıldi	гипостильді
sıklder	циклдер
suranysqat	сұранысхат
kekilchilik	кекілчілік
denonsasıa	денонсация
týrıster	туристер
chyqǵandyn	чықғандын
trapesoedr	трапецоэдр
jahaýrat	жаһаурат
antresol	антресоль
ıodtanǵan	йодтанған
jaýharla	жауһарла
asfálttaý	асфальттау
avıabomby	авиабомбы
bazalt	базальт
radıoındıkatorlyq	радиоиндикаторлық
apelásıalyq	апелляциялық
sılıkol	силиколь
shıampý	шиампу
shahızadalyq	шаһизадалық
dızeldik	дизельдік
charovkalaý	чаровкалау
statıs	статист
fakúltetaralyq	факультетаралық
pomeshıktik	помещиктік
prosentter	проценттер
ýaqit	уақьіт
separasıala	сепарацияла
ıahsyńdy	иахсыңды
chıkildik	чикілдік
bıarman	биарман
kúigpgeı	күігпгеи
rıazat	риазат
bıısım	биисим
aeroshana	аэрошана
ýrbanızasıa	урбанизация
gradırná	градирня
padshah	падшаһ
skýlptor	скульптор
sıentızm	сциентизм
sýbektıvıs	субъективист
sachyrab	сачыраб
býntarlyq	бунтарьлық
emosıa	эмоция
taıandy	тайанды
gamma-fýnksıa	гамма-функция
karsınologıa	карцинология
senalyq	сценалық
vetnamdyq	вьетнамдық
ıatmady	иатмады
energetıkasy	энергетикасы
ındıvıdıým	индивидиум
pasaj	пассаж
glıserıd	глицерид
obektilerdi	объектілерді
atestat	аттестат
okýpasıa	оккупация
chilten	чілтен
desátına	десятина
nıkeld	никельд
sallallahý	саллаллаһу
alveolalyq	альвеолалық
ýltımatıst	ультиматист
lıstıń	листинг
kechesi	кечесі
mýltımedıalyq	мультимедиалық
behesht	беһешт
vegetasıa	вегетация
bahana	бәһана
sanksıalanǵan	санкцияланған
changal	чәнгәл
dvorándyq	дворяндық
skalárlyq	скалярлық
seksıasy	секциясы
ındıkasıalyq	индикациялық
popýlıster	популистер
eshitkech	ешіткеч
telefonogram	телефонограмма
tushshytqysh	тұщытқыш
dekonstrýksıa	деконструкция
bıosenologıa	биоценология
materıalızm	материализм
fýnksıa	функция
psıhıatr	психиатр
dılúsıa	дилюция
mıllıvat	милливатт
proporsıalyq	пропорциялық
dekantasıa	декантация
nýkleoproteıdter	нуклеопротеидтер
jıhazdandyr	жиһаздандыр
ımıgrasıa	иммиграция
agresıashyldyq	агрессияшылдық
karambol	карамболь
gıdropýlt	гидропульт
turnáz	тұрняз
teletranslátor	телетранслятор
podıým	подиум
antısosıalıst	антисоциалист
resıdıv	рецидив
gılotına	гильотина
kaznacheı	казначей
melıorasıalan	мелиорациялан
ılústrasıala	иллюстрацияла
qosymchasymen	қосымчасымен
ıroıkomıkalyq	ироикомикалық
terıgendik	терригендік
messo-soprano	меццо-сопрано
máshhúr	мәшһүр
ıalańǵach	иаланғач
plevrokok	плеврококк
qıamet	қиамет
kapıtalıs	капиталист
ıdealızasıa	идеализация
zodıaktik	зодиактік
abstınensıa	абстиненция
bıhaıaliq	бихаяльіқ
bıodegradasıa	биодеградация
ıabýta	иабута
akvızısıa	аквизиция
IAQTSh	ЯҚТШ
dastarqunchy	дастарқұнчы
danishpańdiq	даньішпаңдьіқ
komýnıkatıvtilik	коммуникативтілік
agresor	агрессор
ıatǵashdy	иатғашды
fýnksıalyq	функциялық
ketkech	кеткеч
notasıa	нотация
nasıonalızasıalaý	национализациялау
ıashynub	иашынұб
rante	рантье
katapýlta	катапульта
emısıasy	эмиссиясы
býrátsha	бурятша
rúkzak	рюкзак
fıltersiz	фильтерсіз
operasıonalızm	операционализм
ımıgrant	иммигрант
ıandi	иандьі
dıspozısıasy	диспозициясы
bosman	боцман
agresıashyl	агрессияшыл
ilý-chalý	ілу-чалу
súchúshdi	сүчүшді
operasıalardyń	операциялардың
avıatarıf	авиатариф
chókúri	чөкүрі
sqemalary	схемалары
redýksıalaǵysh	редукциялағыш
ıamrashdy	иамрашды
chandaǵaı-chandaǵaı	чандағай-чандағай
gala-konsert	гала-концерт
bılárd	бильярд
ındeksasıasy	индексациясы
klasıkalyk	классикалык
chabdurdy	чабдұрды
ekzarasıa	экзарация
taekvondo	таэквондо
bálzam	бальзам
ıýǵrýipdy	иуғруіпды
monopolıstik	монополистік
predıaktıvtilik	предиактивтілік
motoroler	мотороллер
gavhar	гавһар
chemodan	чемодан
hálakat	һалакат
elektrovozy	электровозы
máshhúrlen	мәшһүрлен
koloıd	коллоид
chashyratqy	чашыратқы
ıaǵanlyǵ	иағанлығ
al-baıanlyq	ал-байанлық
merozoıt	мерозоит
embrıologıasy	эмбриологиясы
kartodıagram	картодиаграмма
konseptýalızm	концептуализм
ıaıyqty	иайықты
amınoplasty	аминопласты
ıaǵyqty	иағықты
núsmeıker	ньюсмейкер
mezosıkl	мезоцикл
razrádtal	разрядтал
galvanostegıa	гальваностегия
sılhrom	сильхром
parfúmerlik	парфюмерлік
seleksıala	селекцияла
abdal-abádgeche	абдал-абәдгече
jyrtasbaı	жыртацбай
sırkachtyq	циркачтық
qah-qah	қаһ-қаһ
shlámbýr	шлямбур
osılograf	осциллограф
rýbıdıı	рубидии
reıtıńtik	рейтингтік
ıdılıa	идиллия
konfýsııshildik	конфуцийшілдік
sekýlárızasıalaný	секуляризациялану
ıanǵan	ианған
antısıpasıa	антиципация
behısht	беһишт
dıatomdar	диатомдар
konsorsıým	консорциум
estımatıvtik	эстимативтік
albýmın	альбумин
chýbalań	чубалаң
destılásıalan	дестиляциялан
remısıa	ремиссия
haıýanattar	хайуанаттар
realısik	реалистік
mıllıgram	миллиграмм
evolúsıonıs	эволюционист
gelıosenırlik	гелиоценирлік
ıinchkelendi	иінчкеленді
saldo	сальдо
metalıst	металлист
arı-araı	арй-арай
sekýlárızasıa	секуляризация
sekýlárızasıalan	секуляризациялан
mıtkal	миткаль
matrısasy	матрицасы
sosıalıs	социалист
qııamat	қийамат
ımmobılızasıa	иммобилизация
brıj	бридж
lıngvısti	лингвисті
asımılásıalan	ассимиляциялан
tetrasıklın	тетрациклин
katapýltalyq	катапульталық
chercheý	черчеу
ıarsynshyǵ	иарсыншығ
chishidi	чішіді
mollúskiler	моллюскілер
aerasıalaý	аэрациялау
dýagóı	дуагөи
rúli	рулі
feromagnıttilik	ферромагниттілік
fasıalyq	фациялық
ensefalıti	энцефалиті
ýrasıl	урацил
sosıonıka	соционика
polák	поляк
jalbyr-julbir	жалбыр-жұлбьір
bal	балл
ımplıkasıa	импликация
kálsıle	кальцийле
ıalǵatty	иалғатты
appersıpsıa	апперципция
konsorsıýmy	консорциумы
absolútp	абсолютп
gazbalondy	газбаллонды
leıborıster	лейбористер
balıstıkaly	баллистикалы
krosovka	кроссовка
beınıhaıat	бейниһаят
fantastıka	фантастика
vıljan	вильжан
MSShEU	МСШЕҰ
aktıvasıa	активация
monıster	монистер
depýtasıa	депутация
latıfýndıstiń	латифундистің
vetnam	вьетнам
rúldi	рулді
asosıasıasy	ассоциациясы
krosovkı	кроссовки
chaqpaǵyn	чақпағын
chábalchyq	чәбалчық
ıasady	иасады
solenosıt	соленоцит
ıalyman	иалыман
erúrdi	ерьүрді
barakýda	барракуда
avtomodelshi	автомодельші
gabro	габбро
etıket	этикет
plaskarta	плацкарта
beıapa	бейапа
monarhıster	монархистер
mýzııat	музийат
mıllıardty	миллиардты
válset	вальсет
dıafragma	диафрагма
fraksıashyldyq	фракцияшылдық
ıakýný	йакуну
tushshysy	тұщысы
morzıster	морзистер
krıterıým	критериум
ekspırasıa	экспирация
olımpıadashy	олимпиадашы
chahrajamal	чахражамал
aksıalar	акциялар
bolsman	больцман
deformasıalyq	деформациялық
asıstent	ассистент
ıaraǵy	иарағы
UQShU	ҰҚШҰ
taharathana	таһаратхана
gorıla	горилла
hýdaıa	худайа
trıol	триоль
tujyrimdamasy	тұжырьімдамасы
lısenzıalyq	лицензиялық
ekojúıeler	экожүйелер
haıýanattary	хайуанаттары
qirly	қьірлы
arabıster	арабистер
ınklúzder	инклюздер
galvanotehnıka	гальванотехника
evolúsıa	эволюция
alıgator	аллигатор
ShQB	ШҚБ
dedýksıaly	дедукциялы
azhara	азһара
kılvater	кильватер
artılerıalyq	артиллериялық
chyqaryb	чықарыб
seksıalyq	секциялық
sýbekt	субъект
aplıkata	аппликата
alpınısshe	альпинисше
qarylǵýchy	қарылғучы
múhmin	мүһмін
aleıa	аллея
akseptory	акцепторы
benzaldegıd	бензальдегид
ımpúlsi	импульсі
sosıal-demokratıa	социал-демократия
plashsyz	плащсыз
asfáltti	асфальтті
stımýlásıa	стимуляция
nepman	нэпман
ınternasıonalıstiń	интернационалистің
ırrıgasıalyq	ирригациялық
mıýazar	миуәзар
erozıasy	эрозиясы
týrel	турель
kirpıaz	кірпиаз
kısel	кисель
snıkersnýt	сникерснуть
roıalıstiń	роялистің
dıelektrık	диэлектрик
avıamektep	авиамектеп
palasso	палаццо
de-úre	де-юре
ısha-aı	ища-ай
batıal	батиаль
túbıńgilik	тюбингілік
alúmsılıkattar	алюмсиликаттар
mýltımádenıetti	мультимәдениетті
beınematerıal	бейнематериал
ShUAÓ	ШҰАӨ
ekotehnologıa	экотехнология
prýdensıalyq	пруденциялық
jiranda	жьіранда
karboıdter	карбоидтер
avıabaza	авиабаза
kálka	калька
tatánanyń	татьянаның
ahahalaý	аһаһалау
valútasy	валютасы
ýalaıatlarda	уалайатларда
reaksıalary	реакциялары
álpınısti	альпинисті
chikárt	чікәрт
mıkrosefal	микроцефал
gıdroenergetıkalyq	гидроэнергетикалық
ıarashmaqlyqdyn	иарашмақлықдын
ıarmash	иармаш
balústrada	балюстрада
taekvondoshy	таэквондошы
jaýhaz	жауһаз
geosentrlik	геоцентрлік
ıýflýshdy	иуфлушды
qoıaýyz	қойауыз
kredıt-revolver	кредит-револьвер
álıaıdar	әлиайдар
ekzamen	экзамен
medalısti	медалисті
tkanaralyq	тканьаралық
pres-atashe	пресс-атташе
vısaııa	висайя
empırıa	эмпирия
pesımızm	пессимизм
voklúzder	воклюздер
amoortızasıa	амоортизация
dıalektıka	диалектика
dılem	дилемма
mahıster	махистер
dıspecherleý	диспетчерлеу
sanche-resenzent	санче-рецензент
ıaraǵyn	иарағын
absolútti	абсолютті
gıasınt	гиацинт
geshtaltpsıhologıa	гештальтпсихология
ýazıýar	уазиуар
dúńgirchek	дүңгірчек
bısmıllahı	бисмиллаһи
glúkagon	глюкагон
velvet	вельвет
sholas	схоласт
albınos	альбинос
týrıstik	туристік
terenkýr	терренкур
ateısti	атеисті
alotroptyq	аллотроптық
qychqyrdym	қычқырдым
ınsektısıdter	инсектицидтер
losman	лоцман
destrýksıa	деструкция
operasıalaý	операциялау
alǵysqat	алғысхат
mehanızasıalat	механизациялат
búrokratıa	бюрократия
pres	пресс
adverbıal	адвербиал
terasalaý	террасалау
asosıasıalaný	ассоциациялану
ınterpretasıalaý	интерпретациялау
ıanaldyryq	ианалдырық
keıfıııat	кейфиййат
konotasıa	коннотация
zoosıt	зооцит
kobzar	кобзарь
frahtovshık	фрахтовщик
mobıldilik	мобильділік
pýblısıs	публицист
karser	карцер
flotasıa	флотация
kalomel	каломель
chyryshty	чырышты
sahnasúıer	сахнасүиер
entropıa	энтропия
taıaqlandy	тайақланды
tushshylan	тұщылан
jahattas	жаһаттас
kardıaldi	кардиальді
flúorıt	флюорит
ıashynlyǵ	иашынлығ
poetıkalyq	поэтикалық
kamýfláj	камуфляж
translokasıa	транслокация
ıntıha	интиһа
ınfraksıa	инфракция
ázilgóı	әзілгөи
tańylchaq	таңылчақ
ıarutǵan	иарұтған
úchilenchi	үчіленчі
qurylymdyq-fýnksıonaldyq	құрылымдық-функционалдық
ıashnady	иашнады
avıadesant	авиадесант
búdjettik	бюджеттік
chúkeleý	чүкелеу
al-hamdýlı-l-lahı	ал-хамдули-л-лаһи
jalpas	жалпац
fılokartıster	филокартистер
komısary	комиссары
chabdar	чабдар
fıtosenologıa	фитоценология
sıanıdi	цианиді
gramofon	граммофон
ındýksıaly	индукциялы
avıaklýb	авиаклуб
ekonomısti	экономисті
sábıdeıin	сәбидеиін
dzen-býddızm	дзэн-буддизм
álterasıa	альтерация
chempıonat	чемпионат
gıdroaeromehanıka	гидроаэромеханика
jıhazdaı	жиһаздай
lanset	ланцет
pezometrlik	пьезометрлік
aerologıa	аэрология
chekim-cheıin	чекім-чейін
anýıtant	аннуитант
ámekpaisa	әмекпаіца
aýrý-syrqaýli	ауру-сырқаульі
ıafatttlańdy	иафатттлаңды
avantúrıster	авантюристер
ındıvıdýalızasıalaý	индивидуализациялау
ıapturdy	иаптұрды
ıaǵasynda	иағасында
qaharlan	қаһарлан
dújına	дюжина
demıfologızasıa	демифологизация
geoekologıalyq	геоэкологиялық
baıapar	байапар
psıhodıagnostıka	психодиагностика
monoteıstiń	монотеистің
zahırlık	заһирлик
fın-ýgor	финн-угор
sonchaly	сончалы
kálsı	кальций
ıórgench	иөргенч
berıan	берйан
dáıeksiz	дәиексіз
ıaratǵan	иаратған
sosıometrıa	социометрия
bınehaıat	бинеһайат
ınstıtýsıonalızm	институционализм
aeroterapıa	аэротерапия
arahnoıdıt	арахноидит
chývshady	чувшады
ıaqynyda	иақыныда
óchúmni	өчүмні
korozıa	коррозия
máshhúrlik	мәшһүрлік
óchleri	өчлері
kadırııalyqtar	кадирийалықтар
beınıhaıa	бейниһая
bóıeli	бөиелі
qaharyn	қаһарын
eksport-ımport	экспорт-импорт
gerbısıd	гербицид
vakýmdaý	вакуумдау
sýbalpi	субальпі
kapıtalán	капитальян
anarhısti	анархисті
modernızasıala	модернизацияла
bastańǵi	бастаңғьі
ıabaqý	иабақу
anneksıala	аннекцияла
etnıkalyq	этникалық
ekonomıasy	экономиясы
adektıvtený	адъективтену
vólframıt	вольфрамит
muhajır	мұһажир
manıkúr	маникюр
bıbaha	бибаһа
makroelementter	макроэлементтер
eksedent	эксцедент
balaǵat	баллағат
ıapurtty	иапұртты
verıfıkasıonızm	верификационизм
gıdroızopezder	гидроизопъездер
ıarymlandy	иарымланды
revanshıster	реваншистер
chylama	чылама
ıańshatty	иаңшатты
bólshevıkshe	большевикше
gýmanıs	гуманист
antıarıtmıkalyq	антиаритмикалық
kros-roll	кросс-ролл
fashıs	фашист
komýtasıa	коммутация
zınahar	зинаһар
redýplıkasıa	редупликация
alchalǵy	алчалғы
karanmaıa	каранмайа
gemoroı	геморрой
farmasevtıkalyq	фармацевтикалық
vokabýlár	вокабуляр
ınovasıalyqprosess	инновациялықпроцесс
gaýarla	гауьарла
bısektrısa	биссектриса
mýsadas	муссадас
konklúdenttik	конклюденттік
ýalaıatlardyn	уалайатлардын
zamanaýı	заманауи
galvanoterapıa	гальванотерапия
taııar	таййар
jáhánnem	жәһәннем
golandıalyq	голландиялық
zaiıpa	заіипа
ıanajta	йанажта
cherbek	чербек
patshahı	патшаһи
selúloza	целлюлоза
ıańyla	иаңыла
akseptant	акцептант
ınsýht	инцухт
konglomerasıa	конгломерация
ıapurǵaq	иапұрғақ
ekstrafraht	экстрафрахт
ıanatta	ианатта
gıldıa	гильдия
gabro-amfıbolıt	габбро-амфиболит
krımınalıs	криминалист
empatıa	эмпатия
slavántaný	славянтану
tárıak	тәрйак
akkýmýláttan	аккумуляттан
bıogeosenologıalyq	биогеоценологиялық
desátınadaı	десятинадай
shahadat	шаһадат
tresti	тресті
mýnısıpaldyq	муниципалдық
vóltti	вольтті
dezınseksıa	дезинсекция
rejısór	режиссер
ıaıyndy	иайынды
sosıal-demokrat	социал-демократ
ınternasıonaldy	интернационалды
chattaý	чаттау
manıfes	манифест
gıdrokostúm	гидрокостюм
hıshkım	һишким
vıbrasıalyq	вибрациялық
shtólná	штольня
IAQTJSh	ЯҚТЖШ
motomsıkl	мотомцикл
ıalturdy	иалтұрды
ásgilik	әцгілік
beltıń	бельтинг
qossy-qolań	қоцсы-қолаң
sýbvensıasy	субвенциясы
plagıatshy	плагиатшы
dıahronıa	диахрония
aisylaý	аіцылау
ıatǵuzdy	иатғұзды
hej	хедж
baldary	баллдары
jýrnalıs	журналист
germetızasıala	герметизацияла
aýskúltasıa	аускультация
menshevıktik	меньшевиктік
sentımentaldy	сентиментальды
ımperıalıster	империалистер
ımplantasıalyq	имплантациялық
tafaýıt	тафауит
tonneldi	тоннельді
qylychymny	қылычымны
chaqyldaq	чақылдақ
garmonızasıa	гармонизация
kodıfıkasıa	кодификация
gıdrolokasıalyq	гидролокациялық
polısıasy	полициясы
mýltımedıa	мультимедиа
ıashlyǵ	иашлығ
ınstallásıalyq	инсталляциялық
gaýharpurysh	гауһарпұрыш
ıaǵsydy	иағсыды
materıalısik	материалистік
ılústrasıalaý	иллюстрациялау
reemıgrant	реэмигрант
mılıtarızasıalaý	милитаризациялау
ınovasıalyq	инновациялық
áshekeılet	әшекеилет
revanshısti	реваншисті
ıashaǵu	иашағұ
pıanıstiń	пианистің
rysarlyq	рыцарьлық
múlik-jıhaz	мүлік-жиһаз
dıaftorıt	диафторит
evolúsıonıster	эволюционистер
ıararny	иарарны
deskvamasıa	десквамация
kanalızasıalyq	канализациялық
bordúr	бордюр
prosester	процестер
sadıstiń	садистің
qfqym	қьфқым
aggravasıa	аггравация
ıarmandy	иарманды
chefsheń	чефшең
valma	вальма
shlúzdeý	шлюздеу
solfedjıo	сольфеджио
ımıgrasıalyq	иммиграциялық
vóltıjırovka	вольтижировка
edýard	эдуард
mısıonerlik	миссионерлік
kenchliıú	кенчліиү
baptıster	баптистер
ekinchi	екінчі
modýlon	модульон
ınadaptasıa	инадаптация
sáýlet-kompozısıalyq	сәулет-композициялық
júk-etalon	жүк-эталон
chańbaq	чаңбақ
edınısa	единица
konspırasıa	конспирация
kamer-únker	камер-юнкер
qahary	қаһары
hemmát	һеммәт
marganest	марганецт
predsedatel	председатель
motosıkletsh	мотоциклетш
ýılaıat	уилайат
konslager	концлагерь
charǵysh	чарғыш
geotermaldy	геотермальды
ıdentıfıkasıasy	идентификациясы
gramatıkalaný	грамматикалану
ahaste	әһәсте
trıangýlásıa	триангуляция
profesor	профессор
gavan	гавань
pırometalýrgıa	пирометаллургия
sıfrlyq	цифрлық
ýdochka	удочка
ahahalat	аһаһалат
pomeshık	помещик
seksıaly	секциялы
dısproporsıa	диспропорция
hasadchy	хасадчы
ál-malamatııa	әл-маламатийа
deltaplanershi	дельтапланерші
váls	вальс
qybylagóh	қыбылагөһ
hýdahafız	худаһафиз
ıańqurdy	иаңқұрды
aerobýs	аэробус
atestatt	аттестатт
natýralısti	натуралисті
melıorasıalanatyn	мелиорацияланатын
chýlbýsh	чулбуш
charaına	чарайна
gýlásh	гуляш
ıneseńırovka	инецеңировка
sachúkni	сачүкні
romansement	романцемент
anútagúl	анютагүл
hárqancha	һәрқанча
elchisi	елчісі
alúmınılen	алюминийлен
absolútshildik	абсолютшілдік
benetıt	беннеттит
elektromagnıttik	электромагниттік
áltrýızm	альтруизм
tasqır	тасхир
álbom	альбом
ıaǵutǵan	иағұтған
net-termz	нэт-термз
strýktýralısti	структуралисті
ıýlkýshdy	иулкушды
ıavrydy	иаврыды
keıýana	кейуана
ındees	индеец
qaıýana	қайуана
gýmanısik	гуманистік
shuharat	шұһарат
ıaqaly	иақалы
delegasıa	делегация
kasasy	кассасы
álgeologıalyq	альгеологиялық
gramonal	граммонал
syıaqysy	сыйақысы
ıabusha	иабұша
maǵynas	мағынась
evender	эвендер
graýndeffekt	граундэффект
gaolán	гаолян
gıaloklastıt	гиалокластит
absolút	абсолют
ılústrasıa	иллюстрация
ShİP	ШІП
bólshevıktendir	большевиктендір
fızıatrıa	физиатрия
radıoaparat	радиоаппарат
jıhanger	жиһангер
ıarsydy	иарсыды
sıntoızm	синтоизм
kommýnıkabeldilik	коммуникабельділік
álternatıv	альтернатива
sedent	цедент
telekomýnıkasıa	телекоммуникация
ateısik	атеистік
áleı-túleı	әлеи-түлей
navıgasıalyq	навигациялық
marketıńini	маркетингіні
pıanısti	пианисті
achyǵan	ачыған
emosıaly	эмоциялы
emblema	эмблема
kúnchesine	күнчесіне
aglútınatıvtik	агглютинативтік
varete	варьете
alúvi	аллювий
kórkech	көркеч
matrısa	матрица
ımıjmeıkıng	имиджмейкинг
ıaıqaldy	иайқалды
ıandasha	иандаша
balyqjoıǵy	балықжоиғы
asonans	ассонанс
bektashııa	бекташииа
báhásht	бәһәшт
ıaıylyb	йайылыб
taııaba	таййаба
dúnıadan	дүниадан
paralelogram	параллелограмм
nazalızasıa	назализация
germetızasıa	герметизация
eýrooblıgasıalar	еурооблигациялар
domısılıı	домицилий
ıashnatty	иашнатты
rıdıkúl	ридикюль
chekchek	чекчек
beıaqyl	бейақыл
jaz	джаз
komýnıkasıalyq	коммуникациялық
aqkúıe	ақкүие
shezloń	шезлонг
dúnıaǵa	дүниаға
ınformasıologıa	информациология
metamodel	метамодель
topyraqtyńekologıalyqfýnksıalary	топырақтыңэкологиялықфункциялары
ashysyn	ащысын
redýksıonızm	редукционизм
merkantıldik	меркантильдік
ıalńuq	иалңұқ
ashshytamyr	ащытамыр
sentımentalısti	сентименталисті
ıalǵandy	иалғанды
ıandaq	иандақ
parfúmerıalyq	парфюмериялық
hárqaısysy	һәрқайсысы
forpostar	форпостар
gıdroelektrstansy	гидроэлектрстансы
qýyrchaqny	қуырчақны
aıýanat	айуанат
pılástr	пилястр
flúorograf	флюорограф
stasıonarlyq	стационарлық
gabroıdter	габброидтер
ekvılıbrıs	эквилибрист
valútasyz	валютасыз
búrokratıasyzdandyrý	бюрократиясыздандыру
álpınarı	альпинарий
ortogonal	ортогональ
plasmassa	пластмасса
ısfahanı	исфаһани
akkýltýrasıa	аккультурация
fáls	фальц
fýtýrısik	футуристік
ıaǵutty	иағұтты
zarádtiń	зарядтың
shahııd	шаһйид
kombınasıalyq	комбинациялық
ınstıtýsıonaldyq	институционалдық
chara-para	чара-пара
dıalog	диалог
gorchıchnık	горчичник
shaharıar	шаһариар
artıkýlásıalanbaıtyn	артикуляцияланбайтын
mýmıfıkasıala	мумификацияла
vólttyq	вольттық
operasıasy	операциясы
kavaler	кавальер
materıalızmi	материализмі
olımpıada	олимпиада
kóchelerin	көчелерін
kapelalyq	капеллалық
modýl	модуль
shahmurǵan	шаһмұрған
kostúm-shalbarly	костюм-шалбарлы
asıgnasıa	ассигнация
koról	король
kastodıan	кастодиан
ıaılar	иайлар
mýfel	муфель
konsentrlený	концентрлену
ashyaǵar	ащыағар
asfált	асфальт
ernest	эрнест
epıtafıa	эпитафия
batıpelagıal	батипелагиаль
kaprıchchıo	каприччио
ekonomıkasy	экономикасы
aksent	акцент
mıýalan	миуалан
paraolımpıadalyq	параолимпиадалық
kompúterli	компьютерлі
shapchaq	шапчақ
ıashurunub	иашұрұнұб
mahııan	маһийан
moskvıch	москвич
mılıardtap	милиардтап
vatersizyq	ватерсьізық
ıazmas	иазмас
gastról	гастроль
zýhradaı	зуһрадай
asımetrıalyq	асимметриялық
evroposentrızm	европоцентризм
ShOB	ШОБ
chaqlyq	чақлық
flotasıalaý	флотациялау
ınsıdent	инцидент
baskúl	баскюль
ıastuq	иастұқ
ıdeogram	идеограмма
kontrıbýsıalyq	контрибуциялық
vanadıli	ванадийлі
valútalanǵan	валюталанған
festıvál	фестиваль
kúıreýiski	күйреуіцкі
chartıster	чартистер
kontrıbýsıa	контрибуция
karbosıkldi	карбоциклді
fúcherstik	фьючерстік
ınstansıanyń	инстанцияның
opsıon	опцион
kapıtalısik	капиталистік
valtrap	вальтрап
metılasetat	метилацетат
blok-charter	блок-чартер
geoekonomıkalyq	геоэкономикалық
mýltıtizim	мультитізім
aeroplan	аэроплан
sekvoııadendron	секвойядендрон
nagel	нагель
restıtýsıa	реституция
monsonıt	монцонит
chattaýyq	чаттауық
kálkalaý	калькалау
shpındel	шпиндель
hahlasaq	хаһласақ
rejıseri	режиссері
albedo	альбедо
shpıgel	шпигель
ashshy-tátti	ащы-тәтті
ıafyshǵu	иафышғұ
ınteroreseptorlar	интерорецепторлар
alúmınılený	алюминийлену
fýnksıalardy	функцияларды
bıoenergıa	биоэнергия
jýrnalısiń	журналистің
jıhangerlik	жиһангерлік
aforfe	афорфэ
chaǵyrlady	чағырлады
pechene	печенье
jahanı	жаһани
komýtator	коммутатор
karbúrasıa	карбюрация
chýrrıgeresko	чурригереско
sedalgın	седальгин
osılografıalyq	осциллографиялық
makromarketıń	макромаркетинг
ıntonasıalyq	интонациялық
medıator	медиатор
koefısıenti	коэффициенті
komýnıkasıa	коммуникация
metaloıd	металлоид
sesıa	цессия
álfa-ádis	альфа-әдіс
komısarlyq	комиссарлық
ıadzlytttdy	иадзлытттды
etologıa	этология
ekonomgeografıa	экономгеография
dıafılm	диафильм
transendentik	трансцендентік
ıazyqty	иазықты
ekzıstensıalızm	экзистенциализм
kognısıa	когниция
chamǵyr	чамғыр
selofan	целлофан
reıntegrasıa	реинтеграция
ratıfıkasıa	ратификация
effektisi	эффектісі
melodeklamasıa	мелодекламация
demarkasıalyq	демаркациялық
chańtas	чаңтас
ıapushtylar	иапұштылар
uchyrady	ұчырады
birnechesini	бірнечесіні
MShT	МШТ
okazıonal	окказионал
últramafelik	ультрамафелік
derıvasıalyq	деривациялық
demonstrasıa	демонстрация
kavalerısti	кавалеристі
nahandaı	наһандай
kópfýnksıaly	көпфункциялы
ıasyldy	иасылды
áýkedeı	әукедеи
kreasıonızm	креационизм
ýalaıatynda	уалайатында
dıfferensıalan	дифференциалан
aerodınamıka	аэродинамика
relef	рельеф
býkınıster	букинистер
gırlánda	гирлянда
optımısik	оптимистік
ıashsady	иашсады
gabroıdtený	габброидтену
hashıa	хашия
quqiq	құқьіқ
búrokrattyq	бюрократтық
as-salımııa	ас-салимийа
appelásıa	аппеляция
ahlap-úhleý	аһлап-үһлеу
asımılásıalaný	ассимиляциялану
nepshil	нэпшіл
germetızasıalaý	герметизациялау
dýali	дуальі
maltoza	мальтоза
moh-moh	моһ-моһ
ekskýrsıalyq	экскурсиялық
sıanashurym	сианашұрым
ınsolásıa	инсоляция
aksızdelet	акцизделет
ınvestısıalaý	инвестициялау
zınhar	зінһар
qarjy-eksporttyq	қаржы-экспорттық
pıadeleb	пиаделеб
ekzogamıa	экзогамия
ınfeksıasy	инфекциясы
polárlaný	полярлану
padshahy	падшаһы
shahyzada	шаһызада
ichishdi	ічішді
hımaıat	химайат
ekstremaldyq	экстремалдық
jaýhazyn	жауһазын
pedaldaý	педальдау
efırlik	эфирлік
avıasport	авиаспорт
áltımetr	альтиметр
cherdaýaı	чердауай
operasıalary	операциялары
kafel	кафель
tezovrasıa	тезоврация
velomobıl	веломобиль
tabynchy	табынчы
býlvar	бульвар
proletarıat	пролетариат
ál-jahılııa	әл-жахилийа
bálzamın	бальзамин
radıasıalyq	радиациялық
chylaýysh	чылауыш
seılon	цейлон
bijyrqaılan	бьіжырқайлан
ıýrısdıksıa	юрисдикция
folıkýl	фолликул
chybyrtqy	чыбыртқы
mıttelshpıl	миттельшпиль
dárhal	дәрһал
últramıkroskopıa	ультрамикроскопия
eksperımentt	экспериментт
asfahandy	асфаһанды
flokýlásıa	флокуляция
laktasıa	лактация
mıllenıým	миллениум
QazBShǴZI	ҚазБШҒЗИ
ıańshaq	иаңшақ
ash-iiiıa	аш-іііиа
avaldyq	авальдық
naýısande	науисанде
motofelúga	мотофелюга
prosentteý	проценттеу
paıgah	пайгаһ
avtomobıl	автомобиль
kástóm	кастюм
gýnahár	гунаһәр
gorızontaldy	горизонтальды
tersıa	терция
kóchúrdi	көчүрді
álekeı-chálekeı	әлекей-чәлекей
balııat	балийат
bınaýraldyq	бинауральдық
kvarsıt	кварцит
panıslamıstiń	панисламистің
sınoksal	синоксаль
shaharly	шаһарлы
qarsyny	қарцыны
qfsyǵý	қьфсығу
kýmýlátıvtik	кумулятивтік
aıýandaı	айуандай
gabro-porfırıt	габбро-порфирит
operasıalan	операциялан
ferografıa	феррография
avıakókjıek	авиакөкжиек
QShQQ	ҚШҚҚ
komýnıster	коммунистер
artılerıa	артиллерия
elementi	элементі
kalútron	калютрон
sıkimi	сцйкімі
dúbl	дубль
ekspresıvti	экспрессивті
avtokommýnıkasıa	автокоммуникация
vegetarıanshylyq	вегетарианшылық
morzıstiń	морзистің
mehmanhana	меһманхана
konúnktıvıt	конъюнктивит
zodıak	зодиак
abisyn	абьісын
glandýlosıt	гландулоцит
avıakassa	авиакасса
aýryqchań	аурықчаң
radıolokasıalyq	радиолокациялық
doıyrly	доиырлы
glúkoza	глюкоза
konkresıa	конкреция
korporasıalar	корпорациялар
keılik	кеилік
álpınıster	альпинистер
jaqin-jurt	жақьін-жұрт
mýjtahıd	мужтаһид
ıazsady	иазсады
bahadýr	баһадур
konstrýksıalyq	конструкциялық
alonım	аллоним
komýnıkasıalar	коммуникациялар
mýjtehıd	мужтеһид
orfoepıalyq	орфоэпиялық
ergonomıka	эргономика
madaelızm	мадаэлизм
kapıtalıstiń	капиталистің
ShJM	ШЖМ
epızootıa	эпизоотия
ylaýchy	ылаучы
bahyra	баһыра
ólókchin	өлөкчін
dıstansıalyq	дистанциялық
chertozıan	чертозиан
akýmýlátor	аккумулятор
ShKJ	ШКЖ
ıodıdter	йодидтер
tvorchestvo	творчество
konák	коньяк
ınstıtýsıonaldy	институционалды
shlúzdi	шлюзді
gıpermedıa	гипермедиа
rekvızısıa	реквизиция
vegetarıandyq	вегетариандық
materıaldyq	материалдық
ınkasator	инкассатор
avtotýrıs	автотурист
kontrálto	контральто
operasıala	операцияла
EHSh	ЭХШ
sıntomısın	синтомицин
ekspresema	экспрессема
galperın	гальперин
ollahı	оллаһи
konvensıonalızm	конвенционализм
dıassembleri	диассемблері
ótkinchi	өткінчі
ajıtasıa	ажитация
proporsıalaý	пропорциялау
pýlvınalar	пульвиналар
ekosaıası	экосаяси
aıdaharsyz	айдаһарсыз
doıyrlyq	доиырлық
merchandaızıng	мерчандайзинг
dúnıe-jıhaz	дүние-жиһаз
praporshık	прапорщик
ál-mýrdjıa	әл-мурджиа
syrlassh	сырласьш
dalton-plan	дальтон-план
notarıýstardyń	нотариустардың
mıstıfıkasıala	мистификацияла
ShRT	ШРТ
qazǵanch	қазғанч
ıllústrator	иллюстратор
múltıplıkasıaly	мультипликациялы
ıaılab	иайлаб
týrıseı	туристей
pesımısti	пессимисті
aksıoner	акционер
aýskúltasıalyq	аускультациялық
antrasıt	антрацит
kúrıterapıa	кюритерапия
grasıa	грация
varıanttylyq	варианттылық
eýroınjener	еуроинженер
ıntellıgıbeldik	интеллигибельдік
taharat	таһарат
ınfeksıalyq	инфекциялық
ShBM	ШБМ
mýltımádenıettilik	мультимәдениеттілік
qaldirba	қалдьірба
tıl	тилл
taqýın	тақуин
evstıl	евстиль
varıaqıalan	вариақиялан
mılısıoner	милиционер
leıkoplastyr	лейкопластырь
natýralıs	натуралист
devalvaqıa	девальвақия
affılıasıa	аффилиация
beıkomersıalyq	бейкоммерциялық
dıagenezdik	диагенездік
lemmıń	лемминг
materıaldar	материалдар
men-konsepsıa	мен-концепция
chárápkileý	чәрәпкілеу
vanıl	ваниль
aerozoldi	аэрозольді
chaptyrý	чаптыру
aksentke	акцентке
statısıka	статистика
dıstıllásıalaný	дистилляциялану
bıgúnah	бигүнаһ
ashytushysyn	ащытұщысын
ashylas	ащылас
behýda	беһуда
ezoterıkalyq	эзотерикалық
dıýaldas	диуалдас
obektileriniń	объектілерінің
mýtasıalan	мутациялан
mıtıńilet	митингілет
defektasıa	дефектация
ıanlaryndaqy	ианларындақы
ýrádnık	урядник
hárgez	һәргез
ınnervasıa	иннервация
asbes	асбест
mýnısıpalızasıalaý	муниципализациялау
sırkshi	циркші
ocherkshi	очеркші
beıkúnáh	бейкүнәһ
ash-shýhýd	аш-шуһуд
ashysyraý	ащысырау
sandývach	сандувач
ıalǵadyg	иалғадыг
ımplementasıa	имплементация
sıonısti	сионисті
deklarasıaǵa	декларацияға
anaerobty	анаэробты
ıamanlardyn	иаманлардын
ıhtııar	ихтийар
balans-neto	баланс-нетто
sekýlárlyq	секулярлық
pýblısısıka	публицистика
detaldy	детальды
astronavıgasıa	астронавигация
glosarı	глоссарий
chempıon	чемпион
kompúterlik	компьютерлік
prıseptiń	прицептің
monıtorıń	мониторинг
aksıa	акция
kasalyq	кассалық
páıýand	пәйуанд
aýksıony	аукционы
reverbırasıa	ревербирация
epıstema	эпистема
antroposentrızm	антропоцентризм
ıalyńýlady	иалыңулады
komısıalyq	комиссиялық
beıýaq	бейуақ
kartıńishi	картингіші
kúnáhkar	күнаһкар
resıdıvıstiń	рецидивистің
oportýnıster	оппортунистер
kabel	кабель
býk-velú	бук-вэлью
hezare	һезаре
ateıs	атеист
keptıvti	кэптивті
verbaldy	вербальды
ýchechıktik	учетчиктік
emchegini	емчегіні
navıgasıa	навигация
billóhı	біллөһи
baterfláı	баттерфляй
ekssýdat	экссудат
agglútınasıa	агглютинация
dúralúmınıı	дюралюминий
korespondensıa	корреспонденция
komýtasıalaý	коммутациялау
ındıkasıa	индикация
defolıanttar	дефолианттар
gýmanoıd	гуманоид
veksel-kún	вексель-күн
endosperm	эндосперм
generasıa	генерация
roman-epopeıa	роман-эпопея
kálsıttený	кальциттену
eksedra	экседра
ınvestısıa	инвестиция
qavglby	қавгльбы
dekorasıalyq	декорациялық
neogegelsh	неогегельш
notarıýs	нотариус
tafahhýs	тафаһһус
temúrchi	темүрчі
detal	деталь
ıetilenchisiniń	иетіленчісінің
ınersıalyq	инерциялық
jdahattaný	ждаһаттану
álbatros	альбатрос
jomokchý	жомокчу
týǵııan	туғйиан
kýrer	курьер
ıntensıonalızm	интенционализм
elektrkardıostımýlátor	электркардиостимулятор
atkópchik	аткөпчік
aerogeofızıkalyq	аэрогеофизикалық
etalondyq	эталондық
sındıkalıs	синдикалист
restavrasıalyq	реставрациялық
nıtroglıserın	нитроглицерин
aqyli	ақыльі
sekretarıat	секретариат
býntar	бунтарь
sıonıs	сионист
emotıvızm	эмотивизм
asfálttat	асфальттат
vólt	вольт
álfa	альфа
ashshylyǵy	ащылығы
ıanúldy	ианүлды
revolúsıashyl	революцияшыл
aksessıa	акцессия
nonsomnıak	нонсомниак
pahleýan	паһлеуан
dıelektrlik	диэлектрлік
konstatasıala	констатацияла
chańbyr	чаңбыр
bombardırovshık	бомбардировщик
daıana	дайана
modelde	модельде
stenografıs	стенографист
skalárıa	скалярия
chyǵyryq	чығырық
ekspansıa	экспансия
antısıklondyq	антициклондық
áltron	альтрон
antrasen	антрацен
neomısın	неомицин
bareri	барьері
jaqin-juraǵat	жақьін-жұрағат
azdaha	аздаһа
hılala	һилала
sosıalızm	социализм
ınvestısıalyq	инвестициялық
avtoelektrık	автоэлектрик
gazel	газель
kompúter	компьютер
kıokoı	киокои
mýntaha	мунтаһа
sensýalıstiń	сенсуалистің
dırıjabldeı	дирижабльдей
germetızasıalyq	герметизациялық
mujanchy	мұжанчы
ımplısıtti	имплицитті
ekspromıtasıa	экспромитация
taqýım	тақуим
dıstınksıa	дистинкция
kálsılengen	кальцийленген
zıhindi	зиһінді
epıgram	эпиграмма
ekzoterıkalyq	экзотерикалық
antıkogýlánt	антикогулянт
marham	мәрһәм
saıara	сайара
amofosshy	аммофосшы
memorıaldy	мемориалды
ásheıinde	әшеиінде
ıanlary	ианлары
skelper	скэлпер
búrokratıashyldyq	бюрократияшылдық
kartochkalarynyń	карточкаларының
sosıalısti	социалисті
mýlda	мульда
tesilikchi	тесілікчі
karýsel	карусель
barel	баррель
saýda-ekonomıkalyq	сауда-экономикалық
estetıka	эстетика
ımperıalıs	империалист
lahýtı	лаһути
semásy	семьясы
karotınoıdter	каротиноидтер
salısın	салицин
konsol	консоль
mákıan	мәкиан
ótkúnche	өткүнче
antenaly	антенналы
parfúmershi	парфюмерші
sýrma	сурьма
vestıbýlárly	вестибулярлы
kapıtýlánt	капитулянт
termoıondyq	термоиондық
elektrondy	электронды
desıbeldik	децибелдік
gaýbısa	гаубица
elektrligi	электрлігі
azalııa	азалииа
mıkroekonomıkalyq	микроэкономикалық
kvarsıtter	кварциттер
entazıs	энтазис
transplantasıa	трансплантация
chatqyl	чатқыл
saıasatlyq	сайасатлық
akvızısıasy	аквизициясы
pedıatrlyq	педиатрлық
aksýentasıasy	акцуентациясы
tabaǵıat	табағиат
dıalogtyq	диалогтық
transaksıalyq	трансакциялық
ál-asqab	әл-асхаб
mýstań	мустанг
matras	матрац
valerıan	валериан
ekskýrsovod	экскурсовод
pinhan	пінһан
fýnksıonalızm	функционализм
grant-element	грант-элемент
dárisqana	дәрісхана
kompendıým	компендиум
endokrınologıa	эндокринология
kılıan	килиан
energıasy	энергиясы
pozısıalyq	позициялық
mırakl	миракль
topchan	топчан
chifsheń	чіфшең
vındıkasıa	виндикация
alofon	аллофон
hejer	хеджер
daltonıdter	дальтонидтер
ıalǵanyn	иалғанын
gram	грамм
antıımperıalıstik	антиимпериалистік
álbomdyq	альбомдық
gýmanıstiń	гуманистің
degelmıntteý	дегельминттеу
ıngalátor	ингалятор
glazýr	глазурь
avıasıashy	авиацияшы
jıhansha	жиһанша
salto	сальто
býssol	буссоль
ǵahadnama	ғаһаднама
ınternasıonalısik	интернационалистік
yjdıhad	ыждиһад
termokarsty	термокарсты
sekretarlyq	секретарьлық
ıogýrt	йогурт
qaryncha	қарынча
revızıonıster	ревизионистер
profıl	профиль
negroıd	негроид
deklarasıasyn	декларациясын
bahadúrlik	баһадүрлік
fransýz	француз
ıaqyshdy	иақышды
aeromaǵnıtometr	аэромағнитометр
morzıs	морзист
ýchechık	учетчик
antısıklon	антициклон
barelef	барельеф
kaprıol	каприоль
asfálten	асфальтен
gıdroındıkator	гидроиндикатор
mastoıdıt	мастоидит
jýrnalısıkalyq	журналистикалық
domısılısıı	домицилиций
abstraksıalyq	абстракциялық
zııara	зийара
monısti	монисті
zenzýbel	зензубель
neopalıým	неопаллиум
ekspozısıasy	экспозициясы
transpozısıa	транспозиция
pýnksıa	пункция
repýtasıa	репутация
epılog	эпилог
fılıttený	филлиттену
mılıtarızasıala	милитаризацияла
hazynachylar	хазыначылар
pýrıster	пуристер
ınaýgýrasıa	инаугурация
ıahshysyndyn	иахшысындын
asımılásıa	ассимиляция
ıhtııat	ихтийат
etnomádenı	этномәдени
mýsondyq	муссондық
kúnákhar	күнәкһар
monoteızm	монотеизм
eshalony	эшалоны
sıonıstik	сионистік
troısa	троица
taıaǵu	тайағұ
reaksıashyl	реакцияшыл
asfálttalý	асфальтталу
glıosıt	глиоцит
kondomınıým	кондоминиум
sanıan	саниан
dóskıý	дөцкию
akvalań	акваланг
hárkim	һәркім
akýmýlásıa	аккумуляция
etnosaıasatynyń	этносаясатының
ınventarızasıa	инвентаризация
ShQÓÝ	ШҚӨУ
shahınshah	шаһиншаһ
ývertúra	увертюра
ınkrýstasıa	инкрустация
dıspach	диспач
kalsıfır	кальцифир
monoteısti	монотеисті
saldosy	сальдосы
lıro-epostyq	лиро-эпостық
pedıkúr	педикюр
teramısın	террамицин
shovınısti	шовинисті
ıarpuz	иарпұз
múltıplıkasıalyq	мультипликациялық
dendrosıt	дендроцит
saııada	саййада
sensýalıster	сенсуалистер
trúm	трюм
snarádtardy	снарядтарды
qystaqchy	қыстақчы
qylǵýchy	қылғучы
asbahan	асбаһан
ıapurdy	иапұрды
el-malıkııa	эл-маликийа
túrýchi	түручі
uıaldy	ұйалды
ınspeksıalyq	инспекциялық
aerofotoaparat	аэрофотоаппарат
ýchastoktik	участоктік
endokrınologıalyq	эндокринологиялық
monopolısik	монополистік
mıeloblastar	миелобластар
leıkosıt	лейкоцит
potensıaly	потенциалы
mýfeldi	муфельді
kargah	каргаһ
balásına	балясина
ıapǵaq	иапғақ
ekskýrsant	экскурсант
chellendj	челлендж
mehanısızm	механицизм
komýnıstik	коммунистік
chańǵyraq	чаңғырақ
qychurdy	қычұрды
ShBJNB	ШБЖНБ
etnometodologıa	этнометодология
magıstraldyq	магистральдық
zymiran	зымьіран
franchaızıń	франчайзинг
alúmel	альюмель
solárka	солярка
absorbsıa	абсорбция
aýksıon	аукцион
chendeı	чендей
sýfıks	суффикс
ınersıasyz	инерциясыз
avantúrıstiń	авантюристің
aıdahardyń	айдаһардың
pedıatrıalyq	педиатриялық
ımýnıtettik	иммунитеттік
feleton	фельетон
ahyla-úhile	аһыла-үһьіле
ekspozısıalan	экспозициялан
máıekteý	мәиектеу
ańsasiaýý	аңсасьіауу
mehirman	меһірман
barahna	бараһна
refraksıasy	рефракциясы
rezıdensıa	резиденция
prosesory	процессоры
últramıkrotaldaý	ультрамикроталдау
asqanalyq	асханалық
epısıllogızm	эписиллогизм
chyfylady	чыфылады
fonasıa	фонация
jaýarah	жауараһ
abat	аббат
paralel	параллель
cherkes	черкес
shenbuı	шенбұи
vana	ванна
flúvıoglásıaldyq	флювиогляциалдық
ekspektasıaar	экспектацияар
molárlyq	молярлық
chandan	чандан
ıshshaı	ищай
etnografıa	этнография
dáıeksóz	дәиексөз
gazgolder	газгольдер
reprodýksıa	репродукция
melıorasıalaý	мелиорациялау
birnecheleri	бірнечелері
patıson	паттисон
vanasy	ваннасы
gaýharly	гауһарлы
sosıologıadaǵy	социологиядағы
fashısik	фашистік
kirpıazdaný	кірпиаздану
sholasıka	схоластика
assary	ацсары
batalón	батальон
núton	ньютон
AÓYSSh	АӨЫСШ
reaksıoner	реакционер
nılsborıı	нильсборий
ýiljyǵan	уьілжыған
ekspozısıa	экспозиция
lıngvıstıkalyq	лингвистикалық
súlfıtasıa	сульфитация
defolıasıala	дефолиацияла
ıapushub	иапұшұб
bádáýı	бәдәуи
kapsel	капсель
epıstıl	эпистиль
motel	мотель
neıromedıator	нейромедиатор
materıaldarynynyń	материалдарынының
nakahan	накаһан
ıylynchǵa	иылынчға
ekstra-syılyqaqy	экстра-сыйлықақы
modıfıkasıalaý	модификациялау
razrády	разряды
deterıorasıa	детериорация
altyn-valúta	алтын-валюта
dempıńi	демпингі
ıláhym	иләһым
gelmgols	гельмгольц
kalvınızm	кальвинизм
abstraksıa	абстракция
roıálshi	рояльшы
daktıl	дактиль
evenkılik	эвэнкилік
valdshnep	вальдшнеп
modernısik	модернистік
chá-chámelek	чә-чәмелек
korreksıa	коррекция
kapıtel	капитель
aqıdofıl	ақидофиль
evoınformatıka	эвоинформатика
úchisinden	үчісінден
fılmografıalyq	фильмографиялық
medalıstiń	медалистің
beta-koeffısıent	бета-коэффициент
sosıaldy	социалды
kompozısıasy	композициясы
seıisqana	сейісхана
poemasymaq	поэмасымақ
emirchke	емірчке
adaptasıalyq	адаптациялық
monopolıs	монополист
barham	бәрһам
ıanytty	ианытты
ekonomıkanyń	экономиканың
ımýndy	иммунды
reformıstiń	реформистің
statısıkasy	статистикасы
daltonızm	дальтонизм
estetıkalyq	эстетикалық
ıntrodýksıa	интродукция
ıadagerlik	иадагерлік
jenshen	женьшень
sýbekvatorlyq	субэкваторлық
ıarpatty	иарпатты
cha-cha-cha	ча-ча-ча
zakonchık	закончик
etımologıa	этимология
ekonomıka	экономика
delımıtasıa	делимитация
kartezıanshyldyq	картезианшылдық
vedimistik	ведомстволық
qabyqti	қабықтьі
tushshylaý	тұщылау
ıaǵyrlyǵ	иағырлығ
lıroepos	лироэпос
oponenttik	оппоненттік
kanserogendi	канцерогенді
bıolokasıa	биолокация
endogamıa	эндогамия
revızıonıs	ревизионист
áktas-pýssıonaldy	әктас-пуцционалды
rekomendasıa	рекомендация
fotoreseptor	фоторецептор
reformıs	реформист
vakýmda	вакуумда
dıýana	диуана
etatızm	этатизм
derıvasıa	деривация
baıat-ýa-mamýr	байат-уа-мамур
dosımonologıa	доцимонология
sýbektilik	субьектілік
áshhadý	әшһаду
chebelený	чебелену
palto	пальто
krıstal	кристалл
artıs	артист
dáıekshi	дәиекші
ıashlarny	иашларны
segnetoelektr	сегнетоэлектр
reverberasıa	реверберация
elıps	эллипс
ıntýısıa	интуиция
namaıan	намайан
epıgenetıka	эпигенетика
aıýandarsha	айуандарша
elektronnyı	электронный
jahannamnan	жаһаннамнан
búretka	бюретка
kombınasıa	комбинация
evdemonızm	эвдемонизм
lıaqat	лиақат
pıadeni	пиадені
bımetalızm	биметаллизм
ımıjmeıker	имиджмейкер
dańqqoı	даңққои
ketchúp	кетчуп
energıanyń	энергияның
fashıster	фашистер
paleoglásıologıa	палеогляциология
ınısıaldyq	инициалдық
deformasıalaý	деформациялау
múhtádı	мүһтәди
ıahshylar	иахшылар
ekvator	экватор
agranýlosıtter	агранулоциттер
ımýnıtetteý	иммунитеттеу
býrát	бурят
mıkrorelef	микрорельеф
elektrlik	электрлік
ál-mansýrııa	әл-мансурийа
medıasy	медиасы
eksporttyq-ımporttyq	экспорттық-импорттық
stılıs	стилист
motosıklıst	мотоциклист
aspahanı	аспаһани
seq-qa	сэқ-қа
dzúdo	дзюдо
koeffısenti	коэффиценті
evrıstıka	эвристика
ShjOK	ШжОК
konstıtýsıa	конституция
dıallag	диаллаг
feletondyq	фельетондық
epılásıa	эпиляция
nasıat	насиат
gıdroenergıa	гидроэнергия
máleık	мәлеик
erozıa	эрозия
býriltaı	бурьілтай
álgeologıa	альгеология
kecheli	кечелі
bıǵaıat	биғайат
losıa	лоция
ametıstiń	аметистің
ál-muǵırııa	әл-мұғирийа
koefısıentti	коэффициентті
choǵyltý	чоғылту
gıdroaerodrom	гидроаэродром
metanal	метаналь
lısenzıalan	лицензиялан
ıanchuq	ианчұқ
asfálttatý	асфальттату
mırasıdıa	мирацидия
últrametamorfızm	ультраметаморфизм
rysar	рыцарь
fatalısti	фаталисті
emısıalyq	эмиссиялық
mentaldyq	ментальдық
týrısik	туристік
banagah	банагаһ
epopeıa	эпопея
ıamanlarny	иаманларны
endogendik	эндогендік
neokolonıalızm	неоколониализм
reklamasıa	рекламация
varant	варрант
chyjmyj	чыжмыж
pýrbaha	пурбаһа
ıatduq	иатдұқ
epızootologıa	эпизоотология
sýchýshdy	сучушды
ıatǵaq	иатғақ
ýstrısa	устрица
chapysha	чапыша
avtoınspeksıa	автоинспекция
tarbıalaý	тарбиалау
tushshyly	тұщылы
verıfıkasıalaý	верификациялау
hlorofıl	хлорофилл
rasıonaldyq	рационалдық
sýlfıd	сульфид
deformasıalaný	деформациялану
revalvasıa	ревальвация
qaıachuq	қайачұқ
mısıasyn	миссиясын
degenerasıa	дегенерация
týberkýloproteın	туберкулопротеин
últra	ультра
anagram	анаграмма
zasedatel	заседатель
fólklorıst	фольклорист
patshah	патшаһ
bıogeosenozdy	биогеоценозды
bólshevıktendirý	большевиктендіру
traktasıa	трактация
elektrondanýǵa	электрондануға
ıamlashdy	иамлашды
mıtıńile	митингіле
absolútttik	абсолютттік
modernıstik	модернистік
nıhaıatsyz	ниһаятсыз
komýnısti	коммунисті
ShYHO	ШЫХО
al-qııas	ал-қийас
aqıdofıldik	ақидофильдік
OShE	ОШЕ
senarı	сценарий
shilteı	шілтеи
tushshytyl	тұщытыл
ýchılıshesi	училищесі
falsh	фальшь
kapıtýlásıalyq	капитуляциялық
asqana	асхана
ınternet-addıksıa	интернет-аддикция
aerolog	аэролог
sınorına	синьорина
ıntersýbektıvtik	интерсубъективтік
geteroseldi	гетероцельді
meımechıt	меймечит
TShI	ТШИ
kapıtalısti	капиталисті
klasık	классик
últrasúzgiler	ультрасүзгілер
sýbordınasıalyq	субординациялық
ıańlyǵ	йаңлығ
evolúsıonıstiń	эволюционистің
sosıalızasıa	социализация
kúlt	культ
qaharly	қаһарлы
charanda	чаранда
vanadıı	ванадии
mıýalyq	миуалық
akredıtasıa	аккредитация
akompanement	аккомпанемент
beletrısi	беллетристі
ahylap-úhileý	аһылап-үһьілеу
kardıomıosıtter	кардиомиоциттер
ýchaskesine	учаскесіне
kondensasıalaý	конденсациялау
kóchdiler	көчділер
ındýrasıa	индурация
sekretar	секретарь
denomınasıa	деноминация
ál-ýahhabııa	әл-уаһхабийа
gelmınt	гельминт
dıýanalaý	диуаналау
monorels	монорельс
generalfeldmarshal	генералфельдмаршал
karerızm	карьеризм
ıabytaq	иабытақ
vıkýná	викунья
totıaıynda	тотияйында
hámrahı	һәмраһи
chızabý	чизабу
belláhı	белләһи
aeromektep	аэромектеп
ınsert	инцерт
hónerlik	һөнерлік
mnemogram	мнемограмма
ıarashur	иарашұр
ıamanlashǵanymyz	иаманлашғанымыз
aıanmaıyn	айанмайын
kálkýlásıala	калькуляцияла
sındıkalıster	синдикалистер
krosmen	кроссмен
kontemporızasıa	контемпоризация
ıodtandyrylý	йодтандырылу
padshahym	падшаһым
kranes	кранец
transendentaldyq	трансцендентальдық
ıabaqúlaq	иабақүлақ
vólt-amper	вольт-ампер
kaýchýktar	каучуктар
babııa	бабииа
emúlgator	эмульгатор
gallısızmder	галлицизмдер
konsentrat	концентрат
obekttanýshylyq	объекттанушылық
obstrýksıonıs	обструкционист
sanchyb	санчыб
taracha	тарача
pesa	пьеса
lıllahı	лиллаһи
anıııat	аниййат
jıhazdy	жиһазды
ıdealızasıala	идеализацияла
últrasúzý	ультрасүзу
chorqyndaý	чорқындау
asbessementti	асбестцементті
ıyrlar	йырлар
hárkez	һәркез
bálzamy	бальзамы
shılıń	шиллинг
reanımasıa	реанимация
marketıńi	маркетингі
denýdasıa	денудация
aerogeofızıka	аэрогеофизика
sanksıasy	санкциясы
orbıtal	орбиталь
tárbıat	тәрбиат
ındýstrıalyq-ınnovasıalyq	индустриялық-инновациялық
strýktýralıstiń	структуралистің
fasınasıa	фасцинация
mılenarıstik	милленаристік
dıvergensıa	дивергенция
QR AShM	ҚР АШМ
romanısti	романисті
atraksıa	аттракция
aeronavtıka	аэронавтика
radıojýrnalıster	радиожурналистер
KShD	КШД
mıkrokompúter	микрокомпьютер
ysyrshaq	ыцыршақ
patrúl	патруль
korespondent-bank	корреспондент-банк
altynchy	алтынчы
provıdensıalızm	провиденциализм
deklamasıa	декламация
vahtór	вахтёр
ýnıversalnyı	универсальный
akselbant	аксельбант
sýbektıvısti	субъективисті
ál-asharııa	әл-ашарийа
ınformbúrosy	информбюросы
sensasıaly	сенсациялы
devalvasıalaý	девальвациялау
ıamanlyq	иаманлық
opozısıa	оппозиция
poetıkasy	поэтикасы
anhama	анһама
flásıa	фляция
prıchelına	причелина
reprodýksıalyq	репродукциялық
emanasıa	эманация
federasıalyq	федерациялық
jahatty	жаһатты
materıal	материал
derevná	деревня
ıdealıstiń	идеалистің
kesimdi-syıaqyly	кесімді-сыйақылы
ınstıtýsıonalyq	институционалық
anıgılásıa	аннигиляция
gıdroızotermder	гидроизотермдер
káıfııat	кәйфийат
algologıalyq	альгологиялық
chyraljyń	чыралжың
atele	ателье
ıyrlary	йырлары
nıvaldyq	нивальдық
adrıan	адриан
ShUAA	ШҰАА
qýshıý	қушию
ShQMTÝ	ШҚМТУ
ahahala	аһаһала
ahylap-úhiletý	аһылап-үһьілету
asfálttalynyp	асфальтталынып
mańdaıaldy	маңдайалды
dáıekshe	дәиекше
dıatomıt	диатомит
qabahat	қабаһат
geksaoktaedr	гексаоктаэдр
kavalerıstiń	кавалеристің
sýperetnos	суперэтнос
velotrıal	велотриал
razrád	разряд
bıoekologıa	биоэкология
znachek	значек
prostıl	простиль
desımetrle	дециметрле
taýrııat	таурийат
ınkorporasıalyq	инкорпорациялық
ınflásıalyq	инфляциялық
nedoımke	недоимке
qachalady	қачалады
dezaktıvasıa	дезактивация
tuńǵys-manchjýr	тұңғыс-маньчжур
relátıvızm	релятивизм
eshafot	эшафот
modernızasıalaý	модернизациялау
mıkroobekt	микрообъект
kóchini	көчіні
mınıatúraly	миниатюралы
ekskavator	экскаватор
kastrúl	кастрюль
chatyraý	чатырау
monokýlár	монокуляр
aıaǵyn	айағын
garsbýrgıt	гарцбургит
amplıakıa	амплиакия
ıaǵaqlyǵ	иағақлығ
baharstan	баһарстан
qochǵarnyń	қочғарның
ıdealısti	идеалисті
epıtelıı	эпителий
gázdaı	гяздай
ırasıonalıstik	иррационалистік
aýtentıfıkasıa	аутентификация
oponent	оппонент
valqteý	вальқтеу
pasıfıstiń	пацифистің
rezervasıala	резервацияла
volútın	волютин
tazııa	тазийа
asosıasıaly	ассоциациялы
qorqunychy	қорқұнычы
urǵachyńyzny	ұрғачыңызны
trıýmf	триумф
ıazady	иазады
sháhýat	шаһуат
losón	лосьон
aparteıd	апартеид
vınchester	винчестер
ınjınırıń	инжиниринг
epıtet	эпитет
varıasıa	вариация
bálzamdyq	бальзамдық
affılıırlengen	аффилиирленген
ıartym	иартым
konfesıaly	конфессиялы
gosekzamen	госэкзамен
radıator	радиатор
velsteý	вельцтеу
ıabyshǵur	иабышғұр
múzık-hol	мюзик-холл
chýylǵan	чуылған
sılvınıt	сильвинит
alkaloıd	алкалоид
embargo	эмбарго
konstrýksıa	конструкция
otyn-energetıka	отын-энергетика
fýnksıonaldyq	функционалдық
delúvıılik	делювийлік
regýlátor	регулятор
chúkimeıt	чүкімейт
aerostatıka	аэростатика
fólklorlan	фольклорлан
qylychyn	қылычын
fashıstiń	фашистің
hýapáo	хуапяо
korektýra	корректура
esparset	эспарцет
agranýlosıtoz	агранулоцитоз
trýten	трутень
jumhurıat	жұмһұриат
ıllúvıı	иллювий
anaerob	анаэроб
churqandaý	чұрқандау
tizbektiparallel	тізбектіпараллель
qylychǵa	қылычға
emosıalar	эмоциялар
dalton-jospar	дальтон-жоспар
svoch-birlik	своч-бірлік
deklarasıasy	декларациясы
chekildeýik	чекілдеуік
ad-dýrýzııa	ад-дурузииа
perıstıl	перистиль
erýdıt	эрудит
karateshi	каратэші
bınokl	бинокль
gomologasıa	гомологация
paıaǵash	пайағаш
ahylap-úhilet	аһылап-үһьілет
makroekonomıka	макроэкономика
geterogram	гетерограмма
alegro	аллегро
ınstrýksıa	инструкция
vólta	вольта
mıchmanka	мичманка
JShS	ЖШС
benzel	бензель
chaldaýyt	чалдауыт
zúrıat	зүриат
beıýaqtaı	бейуақтай
búrokrat	бюрократ
nasybaıatym	насыбайатым
avtomodel	автомодель
ıańluq	иаңлұқ
qahhar	қаһһар
feletondat	фельетондат
sılvın	сильвин
býnııad	бунйиад
mınıatúrshyl	миниатюршыл
ýnsıa	унция
qyzylcha	қызылча
hárbir	һәрбір
etımologıalyq	этимологиялық
desátnık	десятник
polskıı	польский
ıýmshady	иумшады
fortochka	форточка
nechaev	нечаев
tushitý	тұшьіту
gaýhartas	гауһартас
sosıal-shovınızm	социал-шовинизм
saprah	сапраһ
vóltmetr	вольтметр
algısıdter	альгицидтер
alergen	аллерген
ekrandaı	экрандай
pastoral	пастораль
fılm	фильм
eleýterokok	элеутерококк
jaıilymdyq	жайьілымдық
portfeldik	портфельдік
gerıan	герйан
artılerıasy	артиллериясы
apalań-topalas	апалаң-топалац
mokýso-áme	мокусо-ямэ
chapchaq	чапчақ
korıandr	кориандр
roıalısti	роялисті
ekloga	эклога
asbesti	асбесті
kúnahyny	күнаһыны
beletrıstıka	беллетристика
ál-ıbadııa	әл-ибадийа
atık	аттик
dańǵoısý	даңғоисы
etnoáleýmettaný	этноәлеуметтану
ShTÁ	ШТӘ
zoosenoz	зооценоз
jahandyq	жаһандық
kapıtýlánttyq	капитулянттық
pancha	пантча
pýblısıstiń	публицистің
trapesıa	трапеция
amýnıchnık	амуничник
chyńrady	чыңрады
fakúlteti	факультеті
nelson	нельсон
aleıasyz	аллеясыз
dekabr	декабрь
koleksıashy	коллекцияшы
portfel	портфель
ınfeksıaly	инфекциялы
túıin-kompúter	түйін-компьютер
delfolına	дельфолина
fonetıs	фонетист
OShU	ОШҰ
eskımos	эскимос
taǵııan	тағйиан
tantem	тантьем
tushshyaǵar	тұщыағар
operasıalyq	операциялық
ınternosıonal	интерноционал
aerobtar	аэробтар
eginchi	егінчі
qachǵundyn	қачғұндын
chimchýir	чімчуір
radıs	радист
sholpi	шолпьі
radıogram	радиограмма
anýıtettik	аннуитеттік
súlfıt	сульфит
ıaǵyrynynyń	иағырынының
antropososıogenez	антропосоциогенез
ıaǵytǵan	иағытған
demonstrasıalyq	демонстрациялық
evakýasıa	эвакуация
karotınoıd	каротиноид
bental	бенталь
nıasın	ниацин
ekstern	экстерн
hokeıshi	хоккейші
ıarturdy	иартұрды
súrealıs	сюрреалист
erıstıka	эристика
ınkýbasıalyq	инкубациялық
retýsh	ретушь
remınısensıa	реминисценция
agresıalyq	агрессиялық
konformnost	конформность
ıadzyshdy	иадзышды
venchýr	венчур
parseldik	парцельдік
ıntoksıkasıa	интоксикация
transpúter	транспьютер
ýallahý	уаллаһу
antıkomýnızm	антикоммунизм
rúlde	рульде
mýltıplıkator	мультипликатор
renesans	ренессанс
jahankez	жаһанкез
kúltıvasıalaý	культивациялау
jýbııar	жубйиар
frýstrasıa	фрустрация
shlúzsiz	шлюзсіз
nýtasıalyq	нутациялық
ıazyndy	иазынды
aksesorıalar	акцессориялар
sándik-kompozısıalyq	сәндік-композициялық
bıajel	биажел
jáhılıa	жәһилия
gallúsınogendik	галлюциногендік
fasılıtasıa	фасилитация
jáhıtshil	жәһитшіл
dúshes	дюшес
proporsıonaldyq	пропорционалдық
kompresıasy	компрессиясы
qaharmansha	қаһарманша
dshǵyr	дьщғыр
taıamýmýna	тайамумуна
mınıatúrashy	миниатюрашы
ınflásıa	инфляция
motosıkl	мотоцикл
ekspedısıalyq	экспедициялық
flúoroz	флюороз
kabeltov	кабельтов
adaptasıa	адаптация
rejısershe	режиссерше
aksesýar	аксессуар
ınjeksıalyq	инжекциялық
pýblısıstik	публицистік
troskızm	троцкизм
assosıanızm	ассоцианизм
fýtýrıster	футуристер
generasıasy	генерациясы
aıdaharsha	айдаһарша
maýiqtyrý	мауьіқтыру
fúchers	фьючерс
manıfesi	манифесті
mýtasıalar	мутациялар
host-kompúter	хост-компьютер
mıkroelement	микроэлемент
dıaftorez	диафторез
bondholder	бондхольдер
aprobasıa	апробация
áskerı-medısınalyq	әскери-медициналық
ımpúlssanaýysh	импульссанауыш
shovınıster	шовинистер
akkomodasıasy	аккомодациясы
normırovshık	нормировщик
peızajıstiń	пейзажистің
dekatenasıalaý	декатенациялау
kabeldik	кабельдік
penchshámbá	пенчшәмбә
kartrıj	картридж
varıanttyq	варианттық
sellúlozdy	целлюлозды
tahtkohy	тахткоһы
ashq	АШҚ
monorelst	монорельст
ıaǵrynlady	иағрынлады
bıaban	биабан
áııýhan	әййуһан
ashylaǵan	ащылаған
kvarstaý	кварцтау
modeldendirý	модельдендіру
komersıalyq	коммерциялық
rasıonalızatorlyq	рационализаторлық
ıarymyny	иарымыны
aksızderdi	акциздерді
pnevmokok	пневмококк
áı-sháı	әи-шәй
baharly	баһарлы
haıýandyq	хайуандық
mılısıasy	милициясы
kattenachcho	каттеначчо
sırrozy	циррозы
anneksıalaý	аннекциялау
vakýmdy	вакуумды
vıolonchelıster	виолончелистер
ıazlyshdy	иазлышды
baroreseptor	барорецептор
spesıfıkasıa	спецификация
alhamdılahı	алхамдилаһи
fılokartıstiń	филокартистің
kaldera	кальдера
múchirip	мүчіріп
transdýksıa	трансдукция
gemosıtopoez	гемоцитопоэз
jaqin-jamaǵat	жақьін-жамағат
gradasıa	градация
kontamınasıa	контаминация
jer-jahan	жер-жаһан
pýblısısik	публицистік
ıaınyń	иайның
natúrmort	натюрморт
kostúmersha	костюмерша
aspahan	аспаһан
chaqyra	чақыра
prıcheskaly	прическалы
aperkot	апперкот
shahbaz	шаһбаз
parfúmerıa	парфюмерия
velokros	велокросс
jahanda	жаһанда
peızajıster	пейзажистер
poezıasy	поэзиясы
skeptısızm	скептицизм
embrıologıa	эмбриология
ıaruqluq	иарұқлұқ
ehe-ehe	еһе-еһе
revızıonısti	ревизионисті
chalańdatý	чалаңдату
jaıdari	жайдарьі
ashshyot	ащыот
jer-jıhan	жер-жиһан
latýn	латунь
ımpúls	импульс
elegısti	элегисті
reanımasıalyq	реанимациялық
ıandyq	иандық
absolúttik	абсолюттік
kartochka	карточка
medıtasıa	медитация
kompetensıa	компетенция
as-sýfrııa	ас-суфрийа
gýttapercha	гуттаперча
ınterlúdıa	интерлюдия
elektrmáshıne	электрмәшине
shalmaı	щалмай
ıntersýbekt	интерсубъект
bedduǵa	бэддұға
hıkaıat	хикайат
medıaqurylym	медиақұрылым
valúta	валюта
birrazrádti	бірразрядты
avıamodelshi	авиамодельші
fálset	фальцет
ajdaha	әждаһа
dıstıllásıala	дистилляцияла
qylynch	қылынч
fraksıalyq	фракциялық
aksıalardy	акцияларды
fılmderdiń	фильмдердің
shahahmet	шаһахмет
nasıonalızasıala	национализацияла
evolúsıasy	эволюциясы
artılerıashy	артиллерияшы
obekt	объект
valútalanbaǵan	валюталанбаған
ǵalıasqar	ғалиасқар
súrealıstiń	сюрреалистің
kros	кросс
radıotranslásıa	радиотрансляция
zıngshpıl	зингшпиль
kónkı	коньки
fashısti	фашисті
ıachandy	иачанды
IASJTSSh	ЯСЖТСШ
ásheıin	әшеиін
sınora	синьора
búro	бюро
qubila	құбьіла
bıahmet	биахмет
ekstraksıa	экстракция
gladıator	гладиатор
petısıa	петиция
shahadatnama	шаһадатнама
pálma	пальма
chyntaq	чынтақ
óch-óch-oı	өч-өч-ой
glútın	глютин
ıazyǵlyǵ	иазығлығ
toquzynchy	тоқұзынчы
darııa	дарйиа
ıaprýshdy	иапрушды
nýtasıa	нутация
álfa-bólshek	альфа-бөлшек
monýmentalıstiń	монументалистің
saıııd	саййид
valqalar	вальқалар
mytilý	мытьілу
demonopolızasıa	демонополизация
ýchılıshelik	училищелік
kamchýn	камчун
antıapeks	антиапекс
eýrochekter	еурочектер
ınkýltýrasıa	инкультурация
radıostansıa	радиостанция
fantasıka	фантастика
mobılızasıala	мобилизацияла
tahara	таһара
prosesterge	процестерге
qylychlaryn	қылычларын
úchúnchi	үчүнчі
sevinch	севінч
terorızmge	терроризмге
aıdaharsymaq	айдаһарсымақ
áýenavıgasıa	әуенавигация
lokomosıı	локомоции
aktór	актер
formaldy	формальды
últradybys	ультрадыбыс
hımıtologıa	химмитология
folıkýlıt	фолликулит
operasıalaný	операциялану
shahana	шаһана
avıahımkúres	авиахимкүрес
sırkach	циркач
ıonızasıalan	ионизациялан
kongresmen	конгрессмен
arnold	арнольд
ál-mazdakııa	әл-маздакийа
elıtarlyq	элитарлық
deltaplan	дельтаплан
palmetta	пальметта
agarchı	агарчи
obektiler	объектілер
dýralúmın	дуралюмин
tushshylaný	тұщылану
aktıvıstiń	активистің
mýláj	муляж
mıýa-baq	миуа-бақ
jahanamǵa	жаһанамға
beıarýaq	бейаруақ
semály	семьялы
monosıt	моноцит
boýlıńge	боулингке
lı-l-láhı	ли-л-ләһи
karıatıda	кариатида
kaýchýkti	каучукті
ıaqrylandy	иақрыланды
mqdısınaly-psıhologıalyq	мқдициналы-психологиялық
álpınıstiń	альпинистің
myshákty	мышьякты
ıntýıtıvti	интуитивті
chajaǵaı	чажағай
kálsıtıtter	кальцититтер
ahylat	аһылат
seksýaldyq	сексуальдық
ıalady	иалады
tergýlikchi	тергулікчі
asfálttan	асфальттан
agroekojúıe	агроэкожүйе
ákýchkeleý	әкучкелеу
revanshısik	реваншистік
okýpasıalaý	оккупациялау
ıapushǵan	иапұшған
fılatelıstiń	филателистің
chyńraq	чыңрақ
dıstıllásıa	дистилляция
ınvolúsıasy	инволюциясы
shlúp	шлюп
sýachy	суатчы
lıpogram	липограмма
galtel	галтель
markór	маркёр
móhrli	мөһрлі
ıaprúldy	иапрүлды
hýkmiıarlyq	хукмійарлық
ShBO	ШБО
paralelızm	параллелизм
balasty	балласты
ıaıylǵan	иайылған
batalónnyı	батальонный
polárlanýy	полярлануы
ıýánsı	юаньци
aksıalaryn	акцияларын
sentımentaldyq	сентиментальдық
akmeızm	акмеизм
sanııa	санийа
kompúterler	компьютерлер
galvanomagnıt	гальваномагнит
zaráád	заряяд
dıagnostıka	диагностика
radıosqema	радиосхема
stenografıstiń	стенографистің
anbııa	анбийа
sentımentalıstiń	сентименталистің
panıslamıster	панисламистер
novela	новелла
nıtrıfıkasıalaýshy	нитрификациялаушы
ekstremızm	экстремизм
mújtahıt	мүжтаһит
ejdıhatsyz	еждиһатсыз
sııasat	сийасат
seleksıalaý	селекциялау
epıkalyq	эпикалық
detranslátor	детранслятор
sosıal	социал
baraj	барраж
ıalǵashdy	иалғашды
karera	карьера
ınformasıalyq	информациялық
múhándıs	мүһәндис
ınflásıaǵa	инфляцияға
modýlátor	модулятор
temúrchimin	темүрчімін
sanchydylar	санчыдылар
gıaloklastar	гиалокластар
búdjetti	бюджетті
sırkúl	циркуль
ırıdektomıa	иридэктомия
profıldik	профильдік
vasaldyq	вассалдық
prosedýra	процедура
monastyr	монастырь
mıeloıdt	миелоидт
transendenttik	трансценденттік
revolúsıonarızm	революционаризм
chikildek	чікілдек
monoteıs	монотеист
eksplantasıa	эксплантация
ıngýmasıa	ингумация
aksıonerl	акционерл
podrád	подряд
glecher	глетчер
ıamaǵlyǵ	иамағлығ
HShYO	ХШЫО
zarádtaný	зарядтану
alaıhı-a-la	алайһи-а-ла
ıafynch	иафынч
lısenzıat	лицензиат
demgeche	демгече
ınersıa	инерция
ındýstrıaldyq	индустриалдық
nomınasıa	номинация
arabıs	арабист
etnosaralyq	этносаралық
zaharlyq	заһарлық
áshekeı	әшекеи
ıashurdy	иашұрды
ÁShB	ӘШБ
ıalyshdy	иалышды
latıfýndısti	латифундисті
hýshmand	һушманд
larvısıd	ларвицид
meshan	мещан
vanadııli	ванадиилі
attestasıa	аттестация
vılochka	вилочка
qaharattaý	қаһараттау
egoızm	эгоизм
ıchazat	ичазат
vıse-mınıstr	вице-министр
karamel	карамель
sensasıalyq	сенсациялық
marksısti	марксисті
hıanat	хианат
aıýankedi	айуанкеді
chaqpas	чақпас
basıtrasın	бацитрацин
rezervıstiń	резервистің
gelmport	гельмпорт
aksıdensıa	акциденция
ıarymaq	иарымақ
ýallahı	уәллаһи
oftálmıa	офтальмия
orfoepıa	орфоэпия
vıolonchelısti	виолончелисті
materıaldyq-tehnıkalyq	материалдық-техникалық
geosınklınal	геосинклиналь
alısıkldi	алициклді
ındýksıalaný	индукциялану
fólklortaný	фольклортану
jiktemes	жіктемесь
aksentýasıalyq	акцентуациялық
eksgýmasıa	эксгумация
etıkalyq	этикалық
qazaqstandiq	қазақстандьіқ
asııat	асийат
chyl-parasyn	чыл-парасын
dezınfeksıalyq	дезинфекциялық
eksped	экспед
dıametr	диаметр
shahybaz	шаһыбаз
vegetasıalyq	вегетациялық
gýttasıa	гуттация
ıntersýbektilik	интерсубъектілік
depopýlásıa	депопуляция
fıdeızm	фидеизм
redaksıalaný	редакциялану
krestgúldiler	крестгүлділер
shuhrat	шүһрәт
javhar	жавһар
ǵalaıhıýassálám	ғалайһиуассәләм
koróldi	корольді
sahattyq	саһаттық
tushshysyn	тұщысын
mıhlat	миһлат
rezúme	резюме
geosentr	геоцентр
fılıaldary	филиалдары
ashshylasý	ащыласу
nýnchaka	нунчака
chanchazy	чанчазы
mılıtarıs	милитарист
kadırııa	кадирийа
gabro-dıabazdyq	габбро-диабаздық
korektor	корректор
efırleri	эфирлері
vestúkı	вестюки
operasıaaralyq	операцияаралық
nálahan	нәлаһан
rejıser	режиссер
delfınarıı	дельфинарий
rahbar	раһбар
genýındik	генуиндік
rekonstrýksıala	реконструкцияла
deratızasıa	дератизация
keshshelik	кещелік
dvıgatel	двигатель
áýelgideı	әуелгідеи
komýnaldy	коммуналды
ıarudy	иарұды
kálsıli	кальцийлі
gospıtál	госпиталь
terarı	террарий
ıaqyny	иақыны
alúsınk	алюцинк
berılı	бериллий
ıaılatty	иайлатты
empırıalyq	эмпириялық
pýblısıs-jazýshy	публицист-жазушы
avalman	авальман
ıntensıa	интенция
ýchastogi	участогі
hoshrýı	хошруи
segizinchi	сегізінчі
chymdaný	чымдану
bólshevızm	большевизм
obektisi	объектісі
braıl	брайль
stagflásıa	стагфляция
ımıtasıa	имитация
qachashlyqyǵa	қачашлықыға
deńgeıaralyq	деңгейаралық
vertlúg	вертлюг
gaýhar	гауһар
ınjınırıńilik	инжинирингілік
asbesosementtik	асбестоцементтік
prodúser	продюсер
komısarıat	комиссариат
sılýet	силуэт
ekolog	эколог
chyraıy	чырайы
QShQ	ҚШҚ
volúta	волюта
kapelmeıster	капельмейстер
tutunchu	тұтұнчұ
statısti	статисті
fúzeláj	фюзеляж
konservasıa	консервация
sýbektıvıster	субъективистер
revolúsıa	революция
fúcherst	фьючерст
perpendıkýlárlik	перпендикулярлық
anımasıalyq	анимациялық
melanosıtter	меланоциттер
ásireınternasıonalısi	әсіреинтернационалисті
bálzamdaý	бальзамдау
totyıaıyn	тотыяйын
pıanıs	пианист
bijyrqaı	бьіжырқай
aýtekologıa	аутэкология
alúmosılıkattar	алюмосиликаттар
mıllıardtaǵan	миллиардтаған
temúrchiniń	темүрчінің
ahtershteven	ахтерштевень
shprıssiz	шприцсіз
asqanashylyq	асханашылық
kodıfıkasıalan	кодификациялан
mobıldi	мобильді
ınfeksıa	инфекция
zaılsýg	зайльцуг
jıhangez	жиһангез
komýtasıalanǵan	коммутацияланған
motahare	мотаһаре
radıojýrnalıstiń	радиожурналистің
áldegıdter	альдегидтер
energoblok	энергоблок
slanes	сланец
ıaldrady	иалдрады
borsh	борщ
párdıýal	пәрдиуал
fólklorlaný	фольклорлану
akredıtıvtik	аккредитивтік
JKShÝ	ЖКШУ
radıasıa	радиация
akseptilik	акцептілік
aglútınatıvti	агглютинативті
nıhaıat	ниһаят
prosenttik	проценттік
chogirtek	чогіртек
ıdealıstik	идеалистік
rasıa	рация
ıoryncha	иорынча
prıcheska	прическа
gaploıdti	гаплоидті
teperchik	теперчік
ınternasıonalshyl	интернационалшыл
ýezik	уездік
pah-pah	паһ-паһ
últramıkrotarazylar	ультрамикротаразылар
materıaldyń	материалдың
álternatıvti	альтернативті
psıhıatrıalyq	психиатриялық
chubartty	чұбартты
áláıhım	әләйһим
kobált	кобальт
STShQ	СТШҚ
ıandurub	иандұрұб
pres-relız	пресс-релиз
makııaa	макийаа
ıarashaıyn	иарашайын
trıenoforoz	триэнофороз
avıasıany	авиацияны
nıgılısti	нигилисті
brúkanes	брюканец
tabernakl	табернакль
mısıoner	миссионер
vaýcher	ваучер
sújetti	сюжетті
karerdiń	карьердің
deskrıpsıa	дескрипция
dıstansıa	дистанция
nıhaıatly	ниһаятлы
ındýızm	индуизм
ıý-qıý	ию-қию
barshınalyq	барщиналық
epıkýreızm	эпикуреизм
shahızat	шаһизат
chilóýjin	чілөужін
ateıster	атеистер
elektronografıa	электронография
hilep-hilep	һілеп-һілеп
charvaka	чарвака
sıanamıd	цианамид
akýmýlátorshy	аккумуляторшы
pýrıstiń	пуристің
ateızm	атеизм
mach-revansh	матч-реванш
materıaldyq-jaýapty	материалдық-жауапты
translásıa	трансляция
asıstentatýra	ассистентатура
kúchlúsi	күчлүсі
suruqchu	сұрұқчұ
rafınasıala	рафинацияла
búrokratıasyzdandyr	бюрократиясыздандыр
mıchmandyq	мичмандық
eksedentiniń	эксцедентінің
kechá-kúndúz	кечә-күндүз
demobılızasıalan	демобилизациялан
valorızasıa	валоризация
spesıfıka	специфика
plash	плащ
anaerostat	анаэростат
elıpsti	эллипсті
slesir	слесарь
plúralızmi	плюрализмі
pýnktýasıa	пунктуация
ásireınternasıonalıster	әсіреинтернационалистер
modelshi	модельші
avantúrıstik	авантюристік
etnokonfessıalyq	этноконфессиялық
karate	каратэ
súchjik	сүчжік
dalton	дальтон
ǵumirnama	ғұмьірнама
transendentaldy	трансценденталды
ıaıǵuq	иайғұқ
eksterıorızasıa	экстериоризация
deportasıa	депортация
amınoplas	аминопласт
jahattaý	жаһаттау
koordınasıalyq	координациялық
mesenat	меценат
últramılonıttik	ультрамилониттік
memorıaldyq	мемориалдық
álhamdýlıllahı	әлхамдулилләһи
bálneologıalyq	бальнеологиялық
haıbatlyq	һайбатлық
prınsıpi	принципі
materıalısti	материалисті
kálkalaný	калькалану
elıpstik	эллипстік
vóltıj	вольтиж
sırkýlárlyq	циркулярлық
sankhá	санкхья
erýdısıa	эрудиция
elektrotermıalyq	электротермиялық
súzeren	сюзерен
debútant	дебютант
ÁShQQ	ӘШҚҚ
ıodattar	йодаттар
aprel	апрель
gavıata	гавиата
ichkeriden	ічкеріден
ınovasıalar	инновациялар
kalancha	каланча
preferensıalar	преференциялар
akýmýláttaný	аккумуляттану
egoortalyqtandyrylǵan	эгоорталықтандырылған
emporlar	эмпорлар
empırıokrıtısızm	эмпириокритицизм
pozısıa	позиция
sadıster	садистер
kostúm	костюм
volapúk	волапюк
jahannam	жаһаннам
uıushdy	ұиұшды
sıkldi	циклді
volıspolkom	волйсполком
qaracha	қарача
asfálttalyný	асфальтталыну
dıafragmaly	диафрагмалы
ekonomıster	экономистер
ǵylymı-restavrasıalaý	ғылыми-реставрациялау
ıaǵrytty	иағрытты
verıfıkasıa	верификация
mehanızasıa	механизация
dıstıllásıalan	дистилляциялан
razrádteý	разрядтау
trúfel	трюфель
ıamlady	иамлады
antıkoagýlánt	антикоагулянт
kemchil	кемчіл
chalpaq	чалпақ
rekonstrýksıalaý	реконструкциялау
asosıasıalyq	ассоциациялық
ıashurdum	иашұрдұм
aptechka	аптечка
tres	трест
bilgech	білгеч
rúl	руль
myltyqchy	мылтықчы
karerıst	карьерист
glásıologıalyq	гляциологиялық
etnostyq	этностық
ahylatyp-úhilet	аһылатып-үһьілет
churqat	чұрқат
approbasıa	аппробация
tıýrosıl	тиуроцилл
appelásıalyq	аппеляциялық
bınokýlárlyq	бинокулярлық
doıbyshy	доибышы
ekspıratorlyq	экспираторлық
shovınıstiń	шовинистің
meshandyq	мещандық
aıtǵach	айтғач
ıetilenchi	иетіленчі
gálmanın	гальманин
stılıster	стилистер
pasıfısti	пацифисті
amınoplastar	аминопластар
ıaratty	иаратты
svekolnık	свекольник
hamıshe	һәмише
tapochka	тапочка
beletrıs	беллетрист
kolektor	коллектор
lısenzıalaný	лицензиялану
ınkorporasıa	инкорпорация
komıvoıajer	коммивояжер
stagnasıa	стагнация
prosentteet	проценттеет
jahannamdyq	жаһаннамдық
mıýala	миуала
mızansena	мизансцена
zaýııa	зауйиа
aerologıalyq	аэрологиялық
mýtasıa	мутация
sýbektıvıstiń	субъективистің
energetıka	энергетика
chaharshenbe	чаһаршенбе
ıuǵluǵ	йұғлұғ
ált	альт
áýejol	авиатрасса
nıgılıstiń	нигилистің
dzú-do	дзю-до
ınformasıalaý	информациялау
gelıosentrlik	гелиоцентрлік
parhaz	парһаз
menýet	менуэт
antısosıalıstik	антисоциалистік
ál-hýrýfııa	әл-хуруфийа
galvanometr	гальванометр
keıýik	кейуік
entelehıa	энтелехия
ıasǵashdy	иасғашды
hozáıka	хозяйка
sementtiń	цементтің
apersepsıa	апперцепция
korabl	корабль
klasıfıkator	классификатор
resenzıalaý	рецензиялау
týnelshi	туннельші
konserj	консьерж
fólklory	фольклоры
leısıt	лейцит
nasıonalızasıa	национализация
mýaııan	муаййан
ekvavalensıa	экваваленция
jıhadshy	жиһадшы
albedosy	альбедосы
hokeıge	хоккейге
ılústrasıalyq	иллюстрациялық
ıneksıalyq	инъекциялық
cháınek	чәйнек
mıkeshe	микеще
obstrýksıonıster	обструкционистер
antısıapatıa	антициапатия
býchıldi	бучильді
fılatelıs	филателист
mazhaby	мәзһабы
mıkrooperasıa	микрооперация
ımperıalısti	империалисті
ıashrushdy	иашрұшды
notarıat	нотариат
ıalǵan	иалған
koefısıent	коэффициент
chyqmaz	чықмаз
solenoıd	соленоид
emosıalyq	эмоциялық
ShUAR	ШҰАР
qoǵamdyq-ekonomıkalyq	қоғамдық-экономикалық
ıamlan	иамлан
doıman	доиман
beıarzý	бейарзу
mınıatúrli	миниатюрлі
ınternasıonal	интернационал
lıngvıs	лингвист
popýlıs	популист
kálkýlátor	калькулятор
sqolostıka	схолостика
OShK	ОШК
gorchısa	горчица
mıstıfıkasıa	мистификация
ýaıimdaǵysh	уайьімдағыш
asfáltta	асфальтта
choǵylldy	чоғыллды
ýchaskeleriniń	учаскелерінің
ashııana	ашийана
braýnıń	браунинг
lobıstik	лоббистік
alpaka	альпака
kastanetter	кастаньеттер
deflátor	дефлятор
padshahlyq	падшаһлық
achyqlanyb	ачықланыб
kanamısın	канамицин
tushshytylý	тұщытылу
chegene	чегене
avtorıtarlyq-búrokratıalyq	авторитарлық-бюрократиялық
jaýahyr	жауаһыр
oktábrına	октябрина
albıdým	альбидум
ınısıasıa	инициация
múltımıllıonerlik	мультимиллионерлік
akredıtteý	аккредиттеу
dimqylda	дьімқылда
allúvıı	аллювии
proporsıa	пропорция
maklerıat	маклериат
zarádtiq	зарядтық
sımýlásıa	симуляция
abstraksıalaý	абстракциялау
ıaqmady	иақмады
jasbaı	жацбай
stancha	станча
dúnıalyqǵa	дүниалықға
emýlsıa	эмульсия
statıstıka	статистика
rafınasıalaý	рафинациялау
serısıt	серицит
jalshy-jaqibaı	жалшы-жақьібай
solıflúksıasy	солифлюкциясы
kınorejısór	кинорежиссёр
bólshevıktik	большевиктік
ahmadııa	ахмадийа
mobılızasıalaný	мобилизациялану
attestasıalaý	аттестациялау
sýdıa	судья
totıaıyndaý	тотияйындау
oıushdy	оиұшды
aparatshy	аппаратшы
rasıonalıs	рационалист
benchmarkıng	бенчмаркинг
bıhesht	биһешт
rotasıasy	ротациясы
sınor	синьор
áshekeılen	әшекеилен
býkınısti	букинисті
resenzent	рецензент
mınımalıs	минималист
fakúltatıvti	факультативті
beshilenchi	бешіленчі
ıasyman	иасыман
ashynaýa	ащынауа
zarádtar	зарядтар
gersog	герцог
gastroenterıt	гастроэнтерит
saýda-operasıalyq	сауда-операциялық
qychqyryb	қычқырыб
ınvolúsıa	инволюция
refaksıa	рефакция
charbas	чарбас
ýzrýpasıa	узрупация
ıamlyǵ	иамлығ
resıdıvi	рецидиві
avantúralyq	авантюралық
kórláhát	көрләһәт
ýchılıshe	училище
aksıany	акцияны
asımetrıa	асимметрия
rııazatny	рийазатны
ıadzyldy	иадзылды
baroko	барокко
cháńpil	чәңпіл
varıant	вариант
geoekologıa	геоэкология
ınkapsýlásıa	инкапсуляция
rasıonalısti	рационалисті
eksportty	экспортты
cháńgish	чәңгіш
chaqpaq	чақпақ
taıady	тайады
manıpýlátor	манипулятор
elektrmetalýrgıa	электрметаллургия
púlt	пульт
gravıtasıa	гравитация
etazol	этазол
dıstıllásıalaý	дистилляциялау
chamylý	чамылу
dıatonıka	диатоника
ıdealızasıalaý	идеализациялау
ishlegýchi	ішлегучі
kanalızasıalanǵan	канализацияланған
ıasaýnyn	иасауның
mıeloblasty	миелобласты
baıtaldi	байталдьі
aıaqyn	айақын
túbıń	тюбинг
mıeloıdti	миелоидті
eıdetızm	эйдетизм
poetıka	поэтика
balas	балласт
spartakıada	спартакиада
prosesti	процесті
gram-ekvıvalent	грамм-эквивалент
monel	монель
sıkldik	цикльдік
barogram	барограмма
ál-ıaqın	әл-йақин
ıntermesso	интермеццо
gemagglútınasıa	гемагглютинация
aýrıkýlárıa	аурикулярия
k-ekonomıkalyq	к-экономикалық
áteshteı	әтештеи
chastýshka	частушка
vırtýaldi	виртуальді
týrıser	туристер
sosıal-shovınıstik	социал-шовинистік
beıasyl	бейасыл
hasharı	һашари
balıstıka	баллистика
dempıńke	демпингке
haıýan	хайуан
kapıtýlásıı	капитуляции
qynatti	қынаттьі
panel	панель
fotoalbom	фотоальбом
keshshe	кеще
jaýirý	жауьіру
alegorıa	аллегория
jýrnalısıka	журналистика
softver	софтвэр
geroın	героин
asyǵystiq	асығыстьіқ
eksporty	экспорты
ýaqytyǵacha	уақытығача
tkandik	тканьдік
shahbaza	шаһбаза
modýldi	модульді
endshpıl	эндшпиль
glısando	глиссандо
modeldendir	модельдендір
antıımperıalıst	антиимпериалист
shahmaran	шаһмаран
ekspedıtor	экспедитор
álpınıseı	альпинистей
reparasıalyq	репарациялық
operasıalardy	операцияларды
avantúrızm	авантюризм
bahýda	баһуда
mılıtarıstiń	милитаристің
revolúsıoner	революционер
balıstıkalyq	баллистикалық
dýalıster	дуалистер
arabıstiń	арабистің
ıatsady	иатсады
energıa	энергия
kompútermen	компьютермен
kalendardaı	календарьдай
qachurtty	қачұртты
ıamady	иамады
ıabushub	иабұшұб
radııaktıvti	радийактивті
ınterpolásıa	интерполяция
gersogıná	герцогиня
moralshy	моральшы
aksıalary	акциялары
klırıń	клиринг
asfálttal	асфальттал
jıhankezdeı	жиһанкездей
ekstraversıa	экстраверсия
rasıonalızasıala	рационализацияла
menstrýasıa	менструация
gastrýlásıa	гаструляция
ǵaziráhil	ғазірәһіл
transpırasıa	транспирация
borychlarny	борычларны
doıyrshy	доиыршы
týǵchysyny	туғчысыны
chabdurǵan	чабдұрған
pýblısıstıkalyq	публицистикалық
modýldik	модульдік
sapıentızasıa	сапиентизация
jıhannan	жиһаннан
chymchym	чымчым
elektrdınamıka	электрдинамика
kompúterdiń	компьютердің
shimbaıyna	шьімбайына
gonokok	гонококк
qorqunch	қорқұнч
ınvestısıany	инвестицияны
fızkýltýra	физкультура
beıakyl	бейакыл
chamaldaý	чамалдау
fýtýrıstiń	футуристің
kombınasıalaý	комбинациялау
devalvasıalan	девальвациялан
vıshnýızm	вишнуизм
sýbektiler	субъектілер
ovasıa	овация
alaıhým	алайһум
seleksıa	селекция
JJSh	ЖЖШ
jıklór	жиклёр
paraleldik	параллельдік
erli-zaıip	ерлі-зайьіп
alparı	альпари
dıaspor	диаспор
kooperasıa	кооперация
lıro-epıkalyq	лиро-эпикалық
mıelopoez	миелопоэз
dedýksıa	дедукция
dıskvalıfıkasıa	дисквалификация
gýahar	гуаһар
konstrýksıanyń	конструкцияның
káýhar	кәуһар
pezometrıalyq	пьезометриялық
evrıtermıa	эвритермия
ırıdodıagnostıka	иридодиагностика
churqan	чұрқан
tenıs	теннис
kannel	каннель
ekaýtıń	эккаутинг
gıdroborasıt	гидроборацит
ımmobıldeý	иммобильдеу
sıkimdi	сцйкімді
empırızm	эмпиризм
ıalǵynny	иалғынны
kvadrýpoldik	квадрупольдік
termokarstyń	термокарстың
ıalyǵlandy	иалығланды
máshhút	мәшһүт
revızıonısik	ревизионистік
chikirttený	чікірттену
galvano	гальвано
ógreıúk	өгреиүк
lıverpýl	ливерпуль
ınvestısıala	инвестицияла
treláj	трельяж
venchýrlik	венчурлік
bádechi	бәдечі
mınomechık	минометчик
alyrcha	алырча
bıoetıka	биоэтика
áshekeıle	әшекеиле
elegıs	элегист
gólfke	гольфке
ıarlady	иарлады
ımýnıtetistik	иммунитетістік
jahandaý	жаһандау
evolúsıonısti	эволюционисті
choqmaqlandy	чоқмақланды
behraq	беһрақ
rasıogalızm	рациогализм
mılenarızm	милленаризм
vıadýk	виадук
mılıtarısti	милитаристі
ınsektofýngısıdter	инсектофунгицидтер
áýeılen	әуеилен
demonetızasıa	демонетизация
sazynchy	сазынчы
kipıazsý	кіпиазсу
rıýaıat	риуаят
ahlap-úhlet	аһлап-үһлет
salúttik	салюттік
lızıń	лизинг
leontev	леонтьев
pahlýan	паһлуан
karatedoda	каратэдода
sibirlinchi	сібірлінчі
ıaıyldy	иайылды
jýrnalısti	журналисті
chapushty	чапұшты
epıdemıa	эпидемия
bılárdshy	бильярдшы
ekspresıonızm	экспрессионизм
radıýs	радиус
nýrgúıa	нургүйа
sınekologıa	синэкология
revolúsıasy	революциясы
obstrýksıonısti	обструкционисті
statısıkalyq	статистикалық
máshhúrlený	мәшһүрлену
konferensıasy	конференциясы
jypilyq	жыпьілық
kalandarııa	каландарийа
mıskıınlıg	мискйинлиг
vıse-konsýl	вице-консул
lúmsým	люмсум
eksterıaldylyq	экстериалдылық
kálsıleý	кальцийлеу
túısiktsh	түйсіктщ
embrıolog	эмбриолог
gelmıntologıa	гельминтология
djoıstık	джоистик
obektıvt	объективт
psıhıatrıasy	психиатриясы
ıashardi	иашардьі
hazardastan	һазардастан
máshhúrúraq	мәшһүрүрақ
transfeksıa	трансфекция
eserler	эсерлер
marksısik	марксистік
ıashunub	иашұнұб
ekvıvalenti	эквиваленті
promo-materıal	промо-материал
chantaq	чантақ
elektrdúmpitkish	электрдүмпіткіш
ehelesý	еһелесу
kahýare	каһуаре
agarcha	агарча
amortızasıalaýǵa	амортизациялауға
sıfrlaý	цифрлау
pasıfıster	пацифистер
dıatomdy	диатомды
mıkromanıpýlátor	микроманипулятор
jasaý-jıhaz	жасау-жиһаз
ıaqını	иақини
kálmar	кальмар
garmon	гармонь
ıahshyraq	иахшырақ
rýdhane	рудһане
qaharynan	қаһарынан
jıhaz-múlik	жиһаз-мүлік
jaýlasýshilyq	жауласушьілық
alýıın	алуийн
ılúmınator	иллюминатор
emansıpasıa	эмансипация
gelmıntter	гельминттер
bıabyraı	биабырай
naýqasqana	науқасхана
kapıllár	капилляр
demobılızasıa	демобилизация
dáriıis	дәріиіс
zarádtaýshy	зарядтаушы
strýktýralıster	структуралистер
apendıks	аппендикс
dermıan	дермиан
bıoındıkator	биоиндикатор
ovoshtyq	овощтық
korespondent	корреспондент
okúltızm	оккультизм
gaýharsha	гауһарша
marchellasy	марчелласы
qóńil-kúı	қөңіл-күи
ııformasıa	ииформация
ıaldruq	иалдрұқ
aplasental	аплацентал
ıstrebıtel	истребитель
eoldyq	эолдық
beınefılm	бейнефильм
ágárche	әгәрче
eshelon	эшелон
gólfstrım	гольфстрим
badyras	бадырац
epıgraf	эпиграф
hýdhýd	һудһуд
bólshevıkten	большевиктен
ekstradasıa	экстрадация
ashshylaný	ащылану
asbosement	асбоцемент
charlar	чарлар
kalsındeý	кальциндеу
ashshylandyrý	ащыландыру
qabildaý	қабьілдау
ıavrytty	иаврытты
sıonıster	сионистер
konsept	концепт
ýchaskesi	учаскесі
ıańadyn	иаңадын
chúberek	чүберек
golensıa	голенция
charqyndaý	чарқындау
neogegelshildik	неогегельшілдік
kvarsty	кварцты
brýsellızat	бруцеллизат
pekıdj-týr	пэкидж-тур
jýnglı	джунгли
qanchyq	қанчық
chalǵynchy	чалғынчы
últramarın	ультрамарин
ıastaldy	иасталды
birneche	бірнече
modeldik	модельдік
eftanazıa	эфтаназия
nıhaıatty	ниһаятты
vúlfenıt	вульфенит
acharlar	ачарлар
terıtorıa	территория
rasıonaldy	рационалды
chevsheń	чевшең
charlata	чарлата
ıahýdılik	яһудилік
pedıatrıa	педиатрия
jıý-jıtsý	джиу-джитсу
kichigtaǵ	кічігтағ
aıýanhana	айуанхана
rafael	рафаэль
emat	еммат
búdjett	бюджетт
ansámbldik	ансамбльдік
HShU	ХШҰ
ráhbárı	рәһбәри
jaıylyı	жайылыи
álıasqar	әлиасқар
bý-elektr	бу-электр
aıaqlary	айақлары
glásıolog	гляциолог
ıntervensıonızm	интервенционизм
marganesti	марганецті
lıngvısıka	лингвистика
sekýlárızasıalyq	секуляризациялық
blok-seksıalyq	блок-секциялық
ıalbaryb	иалбарыб
asanqaıǵilan	асанқайғьілан
kýmıte	кумитэ
materıalıs	материалист
achyǵyna	ачығына
epıfora	эпифора
ýchastok	участок
ıaldab	иалдаб
konúgasıa	конъюгация
komýna	коммуна
qaıýan	қайуан
solıs	солист
kartech	картечь
álpınızm	альпинизм
nahaıat	наһайат
búdjetter	бюджеттер
kınoepopeıa	киноэпопея
tezgench	тезгенч
element	элемент
dıfýzıalaný	диффузиялану
dempıńtik	демпингтік
EShU	ЕШҰ
ıańraq	иаңрақ
antırevolúsıashyl	антиреволюцияшыл
ýalaıat	уалайат
kálsıt	кальцит
sýısıd	суицид
mach	матч
kóchúrúb	көчүрүб
chyvyqlady	чывықлады
gazoıl	газоиль
fortıfıkasıa	фортификация
amonı	аммоний
ıaryqlańdy	иарықлаңды
rezervasıa	резервация
kapıllárlylyq	капиллярлылық
mýnısıpalızasıala	муниципализацияла
allahı	аллаһи
agroekologıa	агроэкология
koordınasıalaý	координациялау
aqtúımesh	ақтүимеш
kompúterlerdiń	компьютерлердің
redýksıalan	редукциялан
shaharbasy	шаһарбасы
hrıstıan	христиан
snarády	снаряды
popýlásıasy	популяциясы
álkeı-chálkeı	әлкей-чәлкей
mújdehıd	мүждеһид
pesımıstiń	пессимистің
salpalar	сальпалар
melhıor	мельхиор
avryıdy	аврыиды
meınfreım	мэйнфрейм
bıhúdá	биһұда
JShMJ	ЖШМЖ
akseptisiz	акцептісіз
radıoefır	радиоэфир
ekonomıs	экономист
gıalomelan	гиаломелан
ıjdahat	иждаһат
avıatehnıkým	авиатехникум
úchisige	үчісіге
vesternızasıa	вестернизация
charzarb	чарзарб
ınspırasıa	инспирация
akordtyq	аккордтық
beıaýyz	бейауыз
popýlısti	популисті
lıchınka	личинка
ınkasatorlyq	инкассаторлық
plastyń	пластың
koleksıalaý	коллекциялау
tırahap	тираһап
mıksosel	миксоцель
fálstart	фальстарт
komısar	комиссар
ensıklopedıa	энциклопедия
pasıvti	пассивті
dıagnostıkasy	диагностикасы
qaharlaný	қаһарлану
ıntýısıonıstik	интуиционистік
tuhmatshy	тұһматшы
aıtkelinchek	айткелінчек
ıamashdy	иамашды
hazınachy	хазиначы
ejdahat	еждаһат
chýalchań	чуалчаң
ǵaıatsyz	ғайатсыз
kesireıý	кецірею
aeropoezd	аэропоезд
chalpań	чалпаң
hol	холл
kansler	канцлер
ýchaskelik	учаскелік
epıstemologıa	эпистемология
ıalyndaq	иалындақ
gemısellúloza	гемицеллюлоза
evrıfagıa	эврифагия
asbester	асбестер
ýhiles	уһілес
beıhýda	бейһуда
menıngokok	менингококк
koeffıqıent	коэффиқиент
dzúdogı	дзюдоги
data-veksel	дата-вексель
hámmátsiz	һәммәтсіз
týláremıa	туляремия
cherakı	чераки
hýshbargııah	хушбаргийаһ
rekvızasıa	реквизация
debút	дебют
glotohronologıa	глоттохронология
shahzada	шаһзада
restavrasıala	реставрацияла
sýlfıdti	сульфидті
stronsıı	стронций
chyraǵdan	чырағдан
ahdpeıman	аһдпейман
sadısti	садисті
ýalaıatlarny	уалайатларны
ıarsyqdy	иарсықды
polısıa	полиция
ekıpaj	экипаж
kórúnch	көрүнч
mıllıamper	миллиампер
lıro-epos	лиро-эпос
eleń-alas	елең-алац
chapkúl	чапкүл
vakýmdyq	вакуумдық
aglomerasıa	агломерация
progres	прогресс
vyborshık	выборщик
tonnel	тоннель
ál-muharram	әл-мұһаррам
etnopsıhologıalsh	этнопсихологияльщ
gıbon	гиббон
geteroregýlásıa	гетерорегуляция
aisylatý	аіцылату
kálkýlásıa	калькуляция
bras	брасс
karatedo	каратэдо
nervúra	нервюра
ekzıstensıalyq	экзистенциялық
modýlásıa	модуляция
ıaqturdy	иақтұрды
qaharyna	қаһарына
mýhabhard	мухабһард
anýıteti	аннуитеті
lvovtyq-varshavalyq	львовтық-варшавалық
chapaly	чапалы
ıaqynyǵa	иақыныға
doıyrlaý	доиырлау
jahattylyq	жаһаттылық
ahlı-l-baıt	аһли-л-байт
ýnter-ofıser	унтер-офицер
qusqana	құсхана
monýmentalısti	монументалисті
kechede	кечеде
medıa-forým	медиа-форум
máshhúrlendir	мәшһүрлендір
alıenasıa	алиенация
ahdııat	ахдйиат
k-ekspedıtorlyq	к-экспедиторлық
elementorganıkalyq	элементорганикалық
segregasıa	сегрегация
mıskıın	мискйин
nıkeldeý	никельдеу
jaýhar	жауһар
uchyrab	ұчыраб
olımpıadalyq	олимпиадалық
ahylap-úhilep	аһылап-үһілеп
áýeıilik	әуеиілік
bádhas	бәдһас
krosovordshyl	кроссовордшыл
ıntensıashyldyq	интенцияшылдық
ındýksıa	индукция
jıhazdal	жиһаздал
artezıandyq	артезиандық
ımpıchment	импичмент
monosılabızm	моносиллабизм
kasa	касса
avıatúsirý	авиатүсіру
motokros	мотокросс
kartrıji	картриджі
monarhıs	монархист
sanksıalary	санкциялары
vestıbýlárlyq	вестибулярлық
dedýksıalaý	дедукциялау
vólframdy	вольфрамды
sımvolısti	символисті
múhmen	мүһмен
chartıs	чартист
mýtahhar	мутаһһар
chalqar	чалқар
demıýrg	демиург
sýbstansıa	субстанция
rezervasıalaý	резервациялау
revanshıs	реваншист
lokasıa	локация
ınkvızısıa	инквизиция
modeldeý	модельдеу
ǵalamdsh	ғаламдьщ
ShMT	ШМТ
slesarlyq	слесарьлық
hadııa	һадийа
tenısi	теннисі
saıası-ekonomıkalyq	саяси-экономикалық
hamangah	һамангаһ
skosıa	скоция
chamaldap	чамалдап
dıapazon	диапазон
balasaý	балластау
zasedateldik	заседательдік
dárgah	дәргаһ
akvalańıs	аквалангис
eskekshi-kanoeshi	ескекші-каноэші
ıanshyldy	ианшылды
bııaban	бийабан
konsepsıa	концепция
ekspresıvtik	экспрессивтік
anal	аннал
abyrjýshylq	абыржушыльқ
mezoıondyq	мезоиондық
hıjrat	һижрат
asıstenttik	ассистенттік
tılıtter	тиллиттер
ahylaý	аһылау
AShÓHF	АШӨХФ
kasasıa	кассация
bronhıaldy	бронхиалды
medıan	медиан
prosesor	процессор
asııan	асийан
achyshdy	ачышды
búrosy	бюросы
matrıarhattyq	матриархаттық
amplıasıa	амплиация
ınflúasıa	инфлюация
redaksıalyq	редакциялық
mınonoses	миноносец
avtoslesar	автослесарь
apodeıktıka	аподеиктика
blok-sqemasy	блок-схемасы
býtılkaýchýk	бутилкаучук
ınternet-aýksıon	интернет-аукцион
ateıstiń	атеистің
ShOK	ШОК
ımpúlstik	импульстік
kapsúl	капсюль
elektrgıtar	электргитар
saqynch	сақынч
polıteızm	политеизм
elúent	элюент
metakompýlátor	метакомпулятор
okazıonalızm	окказионализм
jahatta	жаһатта
sıtoekologıa	цитоэкология
gallúsınoz	галлюциноз
adúdıkasıa	адъюдикация
konfesıalyq	конфессиялық
asfáltobeton	асфальтобетон
korporasıalyq	корпорациялық
molbert	мольберт
tırıak	тирйак
zarády	заряды
plúralızm	плюрализм
ıdealısik	идеалистік
býkınıs	букинист
eýropeoıdtyq	еуропеоидтық
stıpendıat	стипендиат
ekomaqta	экомақта
aıdahardaı	айдаһардай
gıdrosefalıa	гидроцефалия
sosıometrıaly	социометриялы
tanbıh	танбиһ
kálkala	калькала
etımolog	этимолог
sarsınalar	сарциналар
búleten	бюллетень
jentlmen	джентльмен
amálgamasıa	амальгамация
belýj	белудж
gravıtasıalyq	гравитациялық
qahqaha	қаһқаһа
dybysqana	дыбысхана
hámdám	һәмдәм
gıdroızogıps	гидроизогипс
shahname	шаһнаме
abdıkasıa	абдикация
emıtent	эмитент
notarıaldy	нотариалды
dúnıaýı	дүнияуи
ekspertıza	экспертиза
amýnısıa	амуниция
chyljyń	чылжың
polıantty	полиантты
rýberoıd	рубероид
polárlik	полярлық
paralıch	паралич
vestıbúl	вестибюль
mazhab	мазһаб
ıntegrasıalanǵan	интеграцияланған
núans	нюанс
medalıster	медалистер
ıemechúk	иемечүк
ıaqasynda	иақасында
býlın	булинь
ıatlatty	иатлатты
sýbektıvtik	субъективтік
qaharǵa	қаһарға
ate-hıdzı	атэ-хидзи
jahanam	жаһанам
amıak	аммиак
ımprovızasıasy	импровизациясы
okeanarıým	океанариум
hejerleý	хеджерлеу
ınterıorızasıa	интериоризация
geksaedr	гексаэдр
etıldi	этилді
ımperıalıstiń	империалистің
paıýan	пайуан
ıatlady	иатлады
skalpel	скальпель
álfa-ydyraý	альфа-ыдырау
chajamaı	чажамай
parsel	парцель
daqbir	дақбьір
ýtopıster	утопистер
ıapurǵan	иапұрған
konstıtýsıalyq	конституциялық
telespektakl	телеспектакль
hárnemeniń	һәрнеменің
dıskrımınasıa	дискриминация
dıaspora	диаспора
svıdser	свидцер
búkster	бюкстер
makroprosesor	макропроцессор
ıapushǵaq	иапұшғақ
chempıonaty	чемпионаты
bizqúıryq	бізқүирық
komısıasy	комиссиясы
mahatar	маһатар
premer	премьер
jaýharlyq	жауһарлық
sındıkalıstiń	синдикалистің
vermıshel	вермишель
aerotúsirim	аэротүсірім
manıkúrlen	маникюрлен
opsıondyq	опциондық
vakým-súzgish	вакуум-сүзгіш
ınkýbasıalaý	инкубациялау
bólshevık	большевик
búdjetke	бюджетке
haıýansha	хайуанша
varıaqıalaný	вариақиялану
ýtopısti	утописті
ichdiler	ічділер
volúntarıstik	волюнтаристік
korespondenttik	корреспонденттік
gogol	гоголь
jesimpaz	жецімпаз
cháýgim	чәугім
grıláj	грильяж
chıendeý	чиендеу
brıchka	бричка
pesımıs	пессимист
ızoprenoıdter	изопреноидтер
ıamlatty	иамлатты
jábiráhıl	жәбірәһил
varıasıalaý	вариациялау
shahıqat	шаһиқат
búrokrattan	бюрократтан
setandyq	цетандық
optoelektronıka	оптоэлектроника
ıashańurdy	иашаңұрды
barıkada	баррикада
elektrhımıa	электрхимия
kınobúleten	кинобюллетень
gıdroekstrýzıa	гидроэкструзия
polısıkldi	полициклді
chymǵýklandy	чымғукланды
konstrýksıalar	конструкциялар
varágtar	варягтар
charlzton	чарльзтон
seısmogram	сейсмограмма
ıntýıtıvıster	интуитивистер
qychqyrǵan	қычқырған
ınterpretasıalyq	интерпретациялық
regenerasıalyq	регенерациялық
baıarystan	байарыстан
aqıdofıldi	ақидофильді
benchmark	бенчмарк
antıaksedant	антиакседант
konsýldyq	консульдық
shýhrat	шуһрат
búldozer	бульдозер
ıatttlady	иатттлады
ınsenırovka	инсценировка
ıasyǵlyǵ	иасығлығ
dıallagıt	диаллагит
ıahshylarynyń	иахшыларының
gelvın	гельвин
motıvasıa	мотивация
qachurmaı	қачұрмай
delkredere	делькредере
gıpúr	гипюр
kardıogram	кардиограмма
okýpant	оккупант
ekopsıhologıa	экопсихология
radıan	радиан
manıfestiń	манифестің
ıorynchǵa	иорынчға
ımpúlsti	импульсті
fermentasıa	ферментация
ımanentik	имманенттік
antropososıologıa	антропосоциология
ah-úhle	аһ-үһле
gıdrosıklon	гидроциклон
kompozısıalar	композициялар
ıdealıster	идеалистер
dıksıa	дикция
etnomádenısózder	этномәденисөздер
ınterferensıalyq	интерференциялық
tralshık	тральщик
plasıd	пластид
mıeloblas	миелобласт
kúcheshdi	күчешді
preferensıaldyq	преференциалдық
jahıllik	жаһиллік
empırıomonızm	эмпириомонизм
ah-úhleý	аһ-үһлеу
ıaǵaqlyq	иағақлық
taharatsyz	таһаратсыз
abrevıatýra	аббревиатура
radıandyq	радиандық
ıapyǵlyǵ	иапығлығ
revolúsıalyq	революциялық
ıadymda	иадымда
qorityndy	қорьітынды
konsıgnasıalyq	консигнациялық
gelmıntologıalyq	гельминтологиялық
trester	трестер
mahıstiń	махистің
gologramm	голограмма
álme-hál	әлме-һәл
akarısıdter	акарицидтер
ıadymǵa	иадымға
ekstrýzıalyq	экструзиялық
fýtýrıs	футурист
ıaptdy	иаптды
kondısıa	кондиция
ýahabıst	уаһабист
ashyraq	ащырақ
antıkvarıat	антиквариат
tantema	тантьема
brandmaýer	брандмауэр
áleıhıssalam	әлейһиссалам
dachan	датчан
dıanat	дианат
últrakúlgin	ультракүлгін
chottyń	чоттың
aıaq-shanaq	айақ-шанақ
anımasıa	анимация
kabrıol	кабриоль
mazhap	мазһап
attıtúd	аттитюд
antena	антенна
dıamat	диамат
dekapıtasıa	декапитация
mehanızasıalan	механизациялан
álfa-sáýle	альфа-сәуле
karotel	каротель
mızansenalyq	мизансценалық
karbúrator	карбюратор
alergıalyq	аллергиялық
kılson	кильсон
jahanger	жаһангер
monıstik	монистік
nıgılıs	нигилист
ıýrısprýdensıa	юриспруденция
embolıa	эмболия
aplıkasıa	аппликация
shıpchandler	шипчандлер
paladı	палладий
panhan	панһан
mergel	мергель
kostúmi	костюмі
alýshi	алушьі
resıdıvıster	рецидивистер
chaq-chálekeı	чақ-чәлекей
ınkvızısıalyq	инквизициялық
estıpıte	эстипите
dekompılátor	декомпилятор
ekranda	экранда
chekildek	чекілдек
hándasa	һандаса
masqar	масхар
SShF	СШФ
sosıologıasy	социологиясы
spesıfıkalyq	спецификалық
padshahzada	падшаһзада
sosıal-shovınıst	социал-шовинист
mılıtarızasıa	милитаризация
buchaqly	бұчақлы
dıýanashylyq	диуанашылық
dezınformasıa	дезинформация
bıogeosenoz	биогеоценоз
batalóndaı	батальондай
eýrosentrıstik	еуроцентристік
melıorasıasy	мелиорациясы
ıaǵturdy	иағтұрды
aıaǵlydyn	айағлыдын
ınjeksıa	инжекция
megaterıalar	мегатериалар
anapesti	анапесті
ejdıhat	еждиһат
haıýanat	хайуанат
varıaqıalaý	вариақиялау
sıren	сирень
ıaǵyldy	иағылды
dıgıtaldy	дигитальды
ınısıatıva	инициатива
túlen	тюлень
totıaıyn	тотияйын
hachkar	хачкар
doıyrjyǵar	доиыржығар
asfáltıt	асфальтит
ıaqasyndyn	иақасындын
vúrsbýrlyq	вюрцбурлық
haýale	һауале
totıaıyndaı	тотияйындай
dıagram	диаграмма
ıaltǵa	иалтға
ıhtımaa	иһтимаа
estetıkasy	эстетикасы
entomologıa	энтомология
ateıstik	атеистік
kalendar	календарь
ekonomıkalyq	экономикалық
ıadygarlik	йадыгарлік
ımperıalıstik	империалистік
fortepáno	фортепьяно
federasıa	федерация
leksıa	лекция
energetıkalyq	энергетикалық
ancha-muncha	анча-мұнча
elektrtermıalyq	электртермиялық
oftálmoskopıa	офтальмоскопия
aýdıensıa	аудиенция
ınterınternasıonalıster	интернационалистер
ahylatý	аһылату
antıbakterıaldyq	антибактериалдық
epıtaksıa	эпитаксия
ftızıatrıa	фтизиатрия
k-jıhaz	к-жиһаз
monastyrlyq	монастырьлық
gramatıka	грамматика
býmerań	бумеранг
ventılásıa	вентиляция
cháıqap	чәйқап
týfelka	туфелька
kvadrýpol	квадруполь
hárqaısy	һәрқайсы
valmaly	вальмалы
ımpotensıa	импотенция
masıýat	масиуат
tanýın	тәнуин
mollúska	моллюска
ıaǵlady	иағлады
ıadzsady	иадзсады
ekspressıasy	экспрессиясы
bakterıan	бактериан
ıstlah	истлаһ
otrády	отряды
dıastola	диастола
dýalıstik	дуалистік
kompres	компресс
jaýharlan	жауһарлан
ıamaǵu	иамағұ
kompúterbas	компьютербас
alotropıa	аллотропия
modernısti	модернисті
ırradıasıa	иррадиация
abstraksıonızm	абстракционизм
argılıt	аргиллит
arabısti	арабисті
aldyrma	ьалдырма
bıasyl	биасыл
romanıs	романист
jaıalns	жаяльнс
streptokok	стрептококк
lısenzıa	лицензия
bıchare	бичаре
qoǵamdyq-etnıkalyq	қоғамдық-этникалық
farmasıa	фармация
ınstıtýsıalyq	институциялық
fakúltatıv	факультатив
retrospeksıaly	ретроспекциялы
chodzyn	чодзын
sýbektisi	субъектісі
bezeshka	бэзешка
enzımologıa	энзимология
ıýǵrýshdy	иуғрушды
qıamet-qıyndyq	қиамет-қиындық
urdyqchy	ұрдықчы
baktrıan	бактриан
dýplıkasıa	дупликация
broshúrala	брошюрала
replıkasıa	репликация
qıýazyn	қиуазын
shaıhyıslam	шайхыислам
konfıgýrasıa	конфигурация
obektilik-baǵdarlanǵan	объектілік-бағдарланған
sımvolıstiń	символистің
fıksıń	фиксинг
kapsúldik	капсюльдік
dıagnoz	диагноз
ımınoefırler	иминоэфирлер
mahalǵacha	махалғача
revolúsıashyldyq	революцияшылдық
mýsondy	муссонды
chyǵanaq	чығанақ
jaýharlaný	жауһарлану
qıýasyz	қиуасыз
mamlúk	мамлюк
vıbrasıa	вибрация
mádenıaralyq	мәдениаралық
konstrýksıalardy	конструкцияларды
alıterasıa	аллитерация
eksedent-	эксцедент-
keıfıat	кейфиат
flúorografıa	флюорография
elegıa	элегия
elektrolıtshi	электролитші
seksıa	секция
kartezıandyq	картезиандық
retıkýlárlyq	ретикулярлық
vegeterıanshylyq	вегетерианшылық
nýkleın	нуклеин
ablásıa	абляция
kóteriski	көтеріцкі
razezd	разъезд
ımýndyq	иммундық
bıdahat	бидаһат
birtúıir	біртүиір
latıfýndıs	латифундист
ıashady	иашады
telekomýnıkasıalar	телекоммуникациялар
forposty	форпосты
taraýiq	тарауьіқ
súlfaty	сульфаты
áleýmettik-ekonomıkalyq	әлеуметтік-экономикалық
álhamdýllılahı	әлхамдуллилаһи
qylychdyn	қылычдын
kapıtýlásıa	капитуляция
elchilesý	елчілесу
AShTÓ	АШТӨ
falsıfıkasıa	фальсификация
ınternasıonaldyq	интернационалдық
snarádtyń	снарядтың
veksel	вексель
deklarasıalaýdyń	декларациялаудың
avıaapparat	авиааппарат
ysgaıly	ыцгайлы
monoklınal	моноклиналь
áýekasa	әуекасса
oklúzıa	окклюзия
sechishdi	сечішді
qasaıat	қасайат
tonzılıt	тонзиллит
ıntellıgensıasy	интеллигенциясы
máshhúrlendirý	мәшһүрлендіру
mıchman	мичман
razrádtary	разрядтары
akseptik	акцептік
eksperıment	эксперимент
jıhazda	жиһазда
aksıonerlik	акционерлік
dýbláj	дубляж
akvarıým	аквариум
akasıa	акация
tapchurdym	тапчұрдым
dýalıs	дуалист
rekonstrýksıalan	реконструкциялан
padshahsyz	падшаһсыз
beınahaıa	бейнаһая
dedýksıalyq	дедукциялық
esseshi	эссеші
dıastaz	диастаз
losos	лосось
alvanıt	альванит
sosıým	социум
bekdor	бэкдор
komentarı	комментарий
nıkel	никель
revızıonıstiń	ревизионистің
ekrandyq	экрандық
tokarlyq	токарьлық
bolshak	большак
maqataǵıat	мақатағиат
dezınfeksıalaǵysh	дезинфекциялағыш
beletaj	бельэтаж
salmonellez	сальмонеллез
jahandasý	жаһандасу
atrıým	атриум
termoelektrondyq	термоэлектрондық
ıamanyraq	иаманырақ
sterlıń	стерлинг
chınovnıktik	чиновниктік
eho-fraza	эхо-фраза
redaksıalaý	редакциялау
ıntegrasıalaný	интеграциялану
áshekeılený	әшекеилену
gıdroavıasıa	гидроавиация
ımýnıtet	иммунитет
yhtıarly	ыхтиарлы
valútırleý	валютирлеу
ılmenıt	ильменит
ıańalduruq	иаңалдұрұқ
monopolısti	монополисті
skerso	скерцо
grama	грамма
ametıs	аметист
konferensıa	конференция
redaksıalan	редакциялан
lútnıa	лютня
alergıa	аллергия
idyrys	ьідырыс
qyblagóh	қыблагөһ
muchtymdaı	мұчтымдай
velvetka	вельветка
ınfıltrasıa	инфильтрация
baptısti	баптисті
solıster	солистер
nasıonalızasıalan	национализациялан
kvarstan	кварцтан
rasıonalızator	рационализатор
fantastyń	фантастың
mashaıq	машайьқ
spınıń	спиннинг
alúmınotermıa	алюминотермия
tapancha	тапанча
mıkroelektronıka	микроэлектроника
grosmeıster	гроссмейстер
rekvızısıala	реквизицияла
akordeonshy	аккордеоншы
vakýmólsheýish	вакуумөлшеуіш
hamrah	һамраһ
kavalerıs	кавалерист
gastrýlásıalaný	гаструляциялану
mebelshi	мебельші
HAShDQ	ХАШДҚ
ınventarızasıalyq	инвентаризациялық
zııadaraq	зийадарақ
gafeldi	гафельді
agnostısızm	агностицизм
averroızm	аверроизм
devıasıa	девиация
mındal	миндаль
endokrındi	эндокринді
etıologıa	этиология
semánka	цемянка
progresıa	прогрессия
barǵach	баргач
faktorıń	факторинг
antosıan	антоциан
ırızasıa	иризация
týrıserd	туристерд
ınterpretasıalan	интерпретациялан
qaharmandyq	қаһармандық
kechishti	кечішті
qunchuı	құнчұй
ambısıa	амбиция
stenografısti	стенографисті
jýrnalıserdiń	журналистердің
ıadzty	иадзты
nýnsıı	нунций
monoteıster	монотеистер
sosıal-demokratızm	социал-демократизм
pezogıpster	пьезогипстер
jeltis	желтьіс
sentımentalıs	сентименталист
saltasıa	сальтация
jıhazdary	жиһаздары
ıdıoadaptasıa	идиоадаптация
ıildený	йілдену
ınterpretasıa	интерпретация
marksıs	марксист
amortızasıalyq	амортизациялық
qumalhaq	құмалһақ
jýrnalıstıka	журналистика
kanıfol	канифоль
ýjýdııat	ужудийат
konfıskasıala	конфискацияла
koeffıqıenti	коэффиқиенті
eńechesi	еңечесі
ShQO	ШҚО
roıál	рояль
oblıgasıa	облигация
modáldylyq	модальдылық
prosesiniń	процесінің
efferenttik	эфференттік
makroenergıalyq	макроэнергиялық
formasıalar	формациялар
ábilhaıat	әбілһаят
ındýlgensıa	индульгенция
ımpúlsıvtilik	импульсивтілік
álhamdýlıláhı	әлхамдулиләһи
ránchın	рәнчин
antıkomýnıstik	антикоммунистік
qabýldargah	қабулдаргаһ
dvorán	дворян
medıasarapshy	медиасарапшы
mıkrokalkýlátor	микрокалькулятор
adenoıd	аденоид
ınfıltrasıalyq	инфильтрациялық
annýlásıalyq	аннуляциялық
prolongasıa	пролонгация
maǵarli	мағарльі
ál-ýıda	әл-уида
dıffamasıa	диффамация
madársha	мадьярша
anotasıa	аннотация
sken-kod	скэн-код
úndeýchisi	үндеучісі
kompozısıa	композиция
agresıa	агрессия
rezervıs	резервист
portlandsement	портландцемент
chaqtysy	чақтысы
berılıli	бериллийлі
lema	лемма
spırál	спираль
sarcháı	сарчәй
monovaksına	моновакцина
kazeın	казеин
gıbrıdızasıa	гибридизация
leıkosıtter	лейкоциттер
ınvensıa	инвенция
aerofototopografıa	аэрофототопография
bahshat	баһшат
modernıster	модернистер
hámmat	һаммат
radıster	радистер
mılgı	мильги
ıngalásıalyq	ингаляциялық
komýnar	коммунар
birnechesi	бірнечесі
aıdaharsyzdyq	айдаһарсыздық
ınflásıany	инфляцияны
leksıalyq	лекциялық
dıfferensıaldyq	дифференциалдық
varıasıalyq	вариациялық
ıetmegúnche	иетмегүнче
benefısıar	бенефициар
ımplantasıa	имплантация
qossylas	қоцсылас
makrosıkl	макроцикл
plagıat	плагиат
komersıa	коммерция
akýmýlátorly	аккумуляторлы
ıunchyrdy	иұнчырды
ıanudy	ианұды
anarhıs	анархист
óleń-ocherk	өлең-очерк
alúmınat	алюминат
rekonstrýksıalaný	реконструкциялану
gallúsınogen	галлюциноген
asplený	ацплену
epıstemıologıa	эпистемиология
háreket	һәрекет
proporsıonaldy	пропорционалды
moráktaıyn	моряктайын
tahrat	таһрат
obstrýksıonıstiń	обструкционистің
metalýrgıa	металлургия
sensıbılızasıa	сенсибилизация
popýlıstiń	популистің
jıhazdaý	жиһаздау
dokýmentaldy	документальды
astroıda	астроида
fantastar	фантастар
chatlan	чатлан
kýmýlásıa	кумуляция
chaljıma	чалжима
kartel	картель
tachanka	тачанка
polár	поляр
trıazın	триазин
postındýstrıaldyq	постиндустриалдық
beınesújet	бейнесюжет
ınvalúta	инвалюта
kúllıat	күллиат
máslahatgóı	мәслаһатгөй
garmonda	гармоньда
lıngvıstıka	лингвистика
komýnızm	коммунизм
kalsefobtar	кальцефобтар
deflásıalyq	дефляциялық
beıýaıymdyq	бейуайымдық
flań	фланг
kúlúnch	күлүнч
chartısti	чартисті
aqejamshy	ақэжамшы
galvanoplastıka	гальванопластика
bılıverdın	билливердин
ekspress-júkter	экспресс-жүктер
prosesi	процесі
evakýasıalyq	эвакуациялық
ábúıir	әбүиір
aksessorlyq	акцессорлық
AHShI	АХШИ
rúbl	рубль
ınventar	инвентарь
reformasıa	реформация
glokolızasıa	глоколизация
kalsefılder	кальцефилдер
aıylchy	айылчы
neızılber	нейзильбер
vınetka	виньетка
ortopsıhıatrıa	ортопсихиатрия
artel	артель
ekologıalyq	экологиялық
elchileshib	елчілешіб
okýpasıalyq	оккупациялық
sıklogrammasy	циклограммасы
ıalafar	иалафар
as-sýhravardııa	ас-сухравардийа
IASJTKU	ЯСЖТКҰ
metal	металл
solısti	солисті
beıchora	бейчора
ıntaha	интаһа
sımvolıstik	символистік
janýshi	жануьші
jáıýat	жайуат
mıkrosıkl	микроцикл
uchlary	ұчлары
obektıv	объектив
akseptileý	акцептілеу
opozısıalyq	оппозициялық
tán-shan	тянь-шань
revolverli	револьверлі
galvanoskop	гальваноскоп
medısına-sy	медицина-сы
agglútınatıv	агглютинатив
volúntarızm	волюнтаризм
defınısıa	дефиниция
ıhanat	иһанат
jatimsyz	жатьімсыз
brakonerlik	браконьерлік
varene	варенье
mehirban	меһирбан
dotasıa	дотация
abrogasıa	аброгация
týnelshe	туннельше
jámharly	жәмһарлы
glásıodıslokasıa	гляциодислокация
geraldıka	геральдика
ınsınýasıa	инсинуация
hronogram	хронограмма
mýltıpleksteý	мультиплекстеу
ıazyǵshy	иазығшы
elegıster	элегистер
balıstokardıografıa	баллистокардиография
melıorasıala	мелиорацияла
beıamal	бейамал
aıdaharly	айдаһарлы
múdseli	мүдцелі
vıse-admıral	вице-адмирал
parfúmer	парфюмер
ıaqurdy	иақұрды
sıtadel	цитадель
materıalyn	материалын
konstrýksıasy	конструкциясы
ıýzı-raýshan	иузи-раушан
batalóndyq	батальондық
nıkelde	никельде
elektroterapıa	электротерапия
elementteri	элементтері
pýblısıstıka	публицистика
modelershi	модельерші
vólfram	вольфрам
dabylúı	дабылүи
gılza	гильза
ıanvar	январь
karbúrızator	карбюризатор
dezınfeksıalaý	дезинфекциялау
rabaıat	рабайат
desıgram	дециграмм
armán	армян
aıýansha	айуанша
mektep-lıseı	мектеп-лицей
áıdemde	әидемде
eksklúzıvti	эксклюзивті
ábjaýhan	әбжауһан
balony	баллоны
snarád-ushaq	снаряд-ұшақ
kildy	кьілды
hárhıd	һәрхид
asıdafıl	ацидафиль
mýjahıda	мужаһида
aıaıarsgú	айайарсгү
avtogravúra	автогравюра
blastosısta	бластоциста
retrosessıa	ретроцессия
antıpasat	антипассат
aktıvıs	активист
obektıvızm	обьективизм
áchimá-túshi	әтчімә-түщі
gırka	гирька
konfesıa	конфессия
aerosýret	аэросурет
okýlısti	окулисті
donorlyq-akseptorlyq	донорлық-акцепторлық
trepel	трепель
ındýzıým	индузиум
falakachılık	фалакатчилик
gýmanıster	гуманистер
dısertasıa	диссертация
nekahyǵa	некаһыға
bazaltti	базальтті
záreche	зәрече
defolıasıalaý	дефолиациялау
monýmentalıs	монументалист
áhánát	әһәнәт
barbekú	барбекю
ınklúzıvti	инклюзивті
qyıaǵy	қыйағы
prezýmpsıa	презумпция
gıdroslúdalar	гидрослюдалар
tábıat	тәбиат
egosentrızm	эгоцентризм
brakoner	браконьер
ashaǵar	ащағар
sımvolıs	символист
monopolıster	монополистер
beıýada	бейуада
presıń	прессинг
qaıyrymdilyq	қайырымдьілық
zodıakaldyq	зодиакалдық
ırasıonaldyq	иррационалдық
glásıologıa	гляциология
galvanomagnıttik	гальваномагниттік
ızolásıa	изоляция
fın	финн
okýlıs	окулист
modáldyq	модальдық
ekilenchi	екіленчі
lohan	лохань
mıýalaný	миуалану
ál-fatımııýn	әл-фатимийун
dıskrımınasıalaý	дискриминациялау
ıntellıgensıa	интеллигенция
salámı	салями
telnájka	телняжка
vodevıl	водевиль
uchasyn	ұчасын
chiláýjin	чіләужін
normal	нормаль
alúmınıleý	алюминийлеу
eksterer	экстерьер
vezývıan	везувиан
amebıaz	амебиаз
rýhban	руһбан
estafeta	эстафета
tólólikchi	төлөлікчі
razrádteýish	разрядтауыш
bólshevıktený	большевиктену
mıstısızm	мистицизм
ıapmasdyn	иапмасдын
dıqhan	диқһан
býnıan	бунйан
ızotermıalyqprosess	изотермиялықпроцесс
barahın	бараһин
bıatlon	биатлон
chartıstiń	чартистің
melıorasıany	мелиорацияны
kandıl	кандиль
transmısıalyq	трансмиссиялық
ócheshdi	өчешді
vakýmdi	вакуумді
chańylady	чаңылады
ıamanny	иаманны
argýmentasıa	аргументация
myshák	мышьяк
lıngvıster	лингвистер
toıaǵa	тойаға
ál-batınııa	әл-батинийа
dekompozısıa	декомпозиция
birmoıyn	бірмоиын
solo-veksel	соло-вексель
komýnıkasıanyń	коммуникацияның
plasık	пластик
tushshyraq	тұщырақ
restavrasıalaý	реставрациялау
akvalańyshy	аквалангышы
baryqsiz	барықсьіз
konúnktýra	конъюнктура
ınflúentter	инфлюенттер
kolej	колледж
kichidi	кічіді
stıldendirilgen	стильдендірілген
redýksıalaný	редукциялану
mıýadaı	миуадай
elúvı	элювий
operasıonaldy	операционалды
baptıstik	баптистік
aqyrpidaý	ақырьпідау
ıastady	иастады
sýphıl	супхиль
defısıti	дефициті
genosıd	геноцид
ıaryshdy	иарышды
hejıng	хеджинг
oktábir	октябір
shahzat	шәһзат
keıýanalyq	кейуаналық
ashysyra	ащысыра
zııada	зийада
bıogeosenozdyq	биогеоценоздық
zarádtalý	зарядталу
delfın	дельфин
gýmrah	гумраһ
áıdiktený	әидіктену
gımnazıster	гимназистер
jdahattan	ждаһаттан
shahanshah	шаһаншаһ
koordınasıa	координация
alhamdýlı-l-lahı	алхамдули-л-лаһи
ıavlaq	иавлақ
selýloıd	целлулоид
prýdensıaldyq	пруденциалдық
qaharat	қаһарат
aparattyq	аппараттық
ıarsǵaǵ	иарсғағ
polústeri	полюстері
tahııat	тахийат
ekvılıbrıstıka	эквилибристика
otomanızm	оттоманизм
álmanah	альманах
rasıonaldaý	рационалдау
múltımıllıoner	мультимиллионер
bronhoektazıa	бронхоэктазия
barıster	барристер
ákireı	әкіреи
ıamaǵlyq	иамағлық
aerostaty	аэростаты
ınterpolásıalan	интерполяциялан
mertel	мертель
avıaposhta	авиапошта
alpınıada	альпиниада
ıabyndy	иабынды
konstatasıalaý	констатациялау
álbınızm	альбинизм
turmysqana	тұрмысхана
ýtopıstiń	утопистің
iılahı	ійлаһи
iqylas	ьіқылас
stılıstiń	стилистің
kórshi-qolas	көрші-қолац
charh-ý	чарх-у
kazýıstıka	казуистика
desıkasıalaý	десикациялау
dezınfeksıa	дезинфекция
tranzaksıa	транзакция
ekzobıologıa	экзобиология
ıarashdy	иарашды
telefılm	телефильм
rambýle	рамбулье
ashshylyq	ащылық
pasıvtik	пассивтік
anterıným	антерринум
ındýksıalan	индукциялан
metızasıa	метизация
reformıster	реформистер
vetfeldsher	ветфельдшер
bızan-dińgek	бизань-діңгек
sısternalar	цистерналар
kanserogendik	канцерогендік
oportýnızm	оппортунизм
mehrıban	меһрибан
fonar	фонарь
jýrnalıstiń	журналистің
mashhýr	машһур
bıapar	биапар
monıtorıńi	мониторингі
brekchıalar	брекчиялар
ıazlatty	иазлатты
vıolonchelıs	виолончелист
jaqyńdaýshyliq	жақыңдаушыльіқ
ınterer	интерьер
búdjetaralyq	бюджетаралық
gramofonsha	граммофонша
dıammofos	диаммофос
býlba	бульба
slótshilep	слётшілеп
raǵıat	рағиат
ıanyndaǵy	ианындағы
kálsılep	кальцийлеп
artezıan	артезиан
kasır	кассир
okýpasıalaýshy	оккупациялаушы
dzúdoshy	дзюдошы
alkogól	алкоголь
azyn-choǵyn	азын-чоғын
modernızasıa	модернизация
dıalekt	диалект
bıoetıkalyq	биоэтикалық
sıdratý-l-mýntaha	сидрату-л-мунтаһа
knáz	князь
transendentalshyldar	трансценденталшылдар
aktınoıdter	актиноидтер
akseptor	акцептор
berıl	берилл
alaıhı-s-salam	алайһи-с-салам
ınvestısıalardy	инвестицияларды
anaıat	анайат
ıterasıa	итерация
segizlenchi	сегізленчі
koalısıa	коалиция
komısıalar	комиссиялар
qańli	қаңльі
elektrmen	электрмен
menú	меню
avalshy	авальшы
mýmıfıkasıa	мумификация
uchraduq	ұчрадұқ
basıla	бацилла
jaýhardaı	жауһардай
ıáktá-ı	йәктә-и
fýnksıalary	функциялары
karbúratorlaý	карбюраторлау
konsentrasıalaný	концентрациялану
dıagnostıkalyq	диагностикалық
dıspecheri	диспетчері
túlenshe	тюленьше
áýmeserdeı	әумесердеи
slavándar	славяндар
etnotarıh	этнотарих
sıgnalızasıa	сигнализация
baııan	байиан
chapaýylnyń	чапауылның
bolǵuncha	болғұнча
dımaız-charter	димайз-чартер
gıdromelıorasıa	гидромелиорация
modıfıkasıala	модификацияла
komýnıstiń	коммунистің
choqalaý	чоқалау
arhıvolt	архивольт
az-zaıdııa	аз-зайдийа
vındgláıder	виндгляйдер
sosıologızm	социологизм
agahsyz	агаһсыз
raıis	райьіс
sýbstıtýsıa	субституция
súlfat	сульфат
uıalurlar	ұйалұрлар
chaıpalaý	чайпалау
aerotúsirý	аэротүсіру
ekspressıa	экспрессия
vıse-kansler	вице-канцлер
dıhqanchılıq	диһқанчилиқ
sahraýı	сахрауи
artıkýlásıalyq	артикуляциялық
atıka	аттика
sesıonarı	цессионарий
basılder	бацилдер
mýltmádenı	мультмәдени
mıchýrınshi	мичуринші
medalıs	медалист
korespondensıasy	корреспонденциясы
artıkl	артикль
ıadzym	иадзым
kapela	капелла
ushtastiryl	ұштастьірыл
asharııa	ашарийа
ıspahan	испаһан
jalaqorliq	жалақорльіқ
búdjet	бюджет
formýlár	формуляр
ataraksıa	атаракция
medısınalyq	медициналық
bandachılık	бандачилик
rııazat	рийазат
parhız	пәрһиз
álpınıs	альпинист
búrokratıalyq	бюрократиялық
bımoraldyq	биморальдық
gratıfıkasıa	гратификация
berekeldi	бэрекелді
koefısıentiniń	коэффициентінің
bımetal	биметалл
mass-medıa	масс-медиа
sımvolısik	символистік
ekologıasy	экологиясы
chyqǵaı	чықғай
transendentalııler	трансценденталийлер
nakahaa	накаһаа
geoenergetıka	геоэнергетика
chabǵan	чабған
gýmanısti	гуманисті
eýroaksıa	еуроакция
aglútınatıvtilik	аглютинативтілік
ashylandyr	ащыландыр
moraldi	моральді
ahlap-úhletý	аһлап-үһлету
bınıhaıat	биниһаят
dıskrımınasıalyq	дискриминациялық
bıatlonshy	биатлоншы
aksentýasıa	акцентуация
chemirchek	чемірчек
ıjdahatty	иждаһатты
shaýhat	шауһат
dıagonal	диагональ
spekýlátıvti	спекулятивті
gramatıkalyq	грамматикалық
obektileri	объектілері
bıogenımkaliq	биогенимкальіқ
taııabat	таййабат
ımpúlstilik	импульстілік
padshahyńa	падшаһыңа
monoteıstik	монотеистік
matrıarhat	матриархат
kegelban	кегельбан
kapsúlsiz	капсюльсіз
jıhanker	жиһанкер
ıatti	иаттьі
jahankezdik	жәһанкездік
áriptik-sıfrlyq	әріптік-цифрлық
at-taqııa	ат-тақийа
mýs	мусс
desımetr	дециметр
ekspozısıalaný	экспозициялану
ofshorlyq	оффшорлық
alúmınıli	алюминийлі
avıamodel	авиамодель
tonaldyq	тональдық
anarhıster	анархистер
kostúmsheń	костюмшең
churqyraý	чұрқырау
postkomýnıstik	посткоммунистік
dıalektologıalyq	диалектологиялық
beshinchi	бешінчі
emýlátor	эмулятор
dıalektızm	диалектизм
dıksıalyq	дикциялық
ıllúzıonızm	иллюзионизм
endokrınolog	эндокринолог
úımekchi	үймекчі
mýıassar	муйассар
ınterpolásıalaý	интерполяциялау
zarádtal	зарядтал
gametosıt	гаметоцит
ıadzyǵlyǵ	иадзығлығ
oksúmoron	оксюморон
haıalyǵ	хайалығ
dákon	дьякон
pres-konferensıa	пресс-конференция
aleıaly	аллеялы
terorıstik	террористік
konúnksıa	коньюнкция
sosıalıstiń	социалистің
galvanosoqqyly	гальваносоққылы
plasıka	пластика
ShQTÝ	ШҚТУ
geksatetroedr	гексатетроэдр
háıhat	һәйһат
sosıologıa	социология
ıýńlady	иуңлады
aqparattyq-kommýnıkasıalyq	ақпараттық-коммуникациялық
jaýahır	жауаһир
bloktyq-mýltıplekstik	блоктық-мультиплекстік
monoftoń	монофтонг
samıt	саммит
metalogend	металлогенд
chekeneleý	чекенелеу
konsolıdasıa	консолидация
qadir-sasıet	қадір-цасиет
prolúvıı	пролювий
feromagnıt	ферромагнит
masqaf	масхаф
romanıster	романистер
tásháhýd	тәшәһуд
ınspeksıasy	инспекциясы
aktýalandirý	актуаландьіру
galmırolız	гальмиролиз
deklarasıalyq	декларациялық
sılıkomarganes	силикомарганец
solánka	солянка
qychqyrdy	қычқырды
ınternasıonalıs	интернационалист
ıarlyq	иарлық
adaptasıasy	адаптациясы
peleń	пеленг
áltrýıst	альтруист
marsıa	марсиа
últradybystyq	ультрадыбыстық
koefısıentter	коэффициенттер
paról	пароль
ıalaldy	иалалды
býqııa	буқийа
vıse-premer	вице-премьер
dıabet	диабет
amonal	аммонал
kreml	кремль
apsel	апсель
barıkadalaý	баррикадалау
masaget	массагет
bagı	багги
mýnısıpalıtet	муниципалитет
monýmentalıster	монументалистер
krımınalısti	криминалисті
konsert	концерт
ıadzyndy	иадзынды
rekýperasıa	рекуперация
galvanotehnıkalyq	гальванотехникалық
áshekeıli	әшекеилі
prosedýralyq	процедуралық
doıyrtpaq	доиыртпақ
kichiginiń	кічігінің
alhamdý	алһамду
jaýynchyl	жауынчыл
ıaǵsady	иағсады
fılıaly	филиалы
fatalıs	фаталист
absolútt	абсолютт
kvadrıplbar	квадрипльбар
jahannamdaı	жаһаннамдай
fotofıcher	фотофичер
áshekeıleý	әшекеилеу
ebeıaýyz	ебейауыз
dıssoqıasıa	диссоқиация
progresıvti	прогрессивті
etnodemografıa	этнодемография
kılogram-kúsh	килограмм-күш
ıalńus	иалңұс
manıkúrlený	маникюрлену
matrısalyq	матрицалық
ıjdıhat	иждиһат
gelmıntoz	гельминтоз
anderaıter	андеррайтер
glosa	глосса
eksklúzıv	эксклюзив
retrosedent	ретроцедент
presedent	прецедент
jahandandyrý	жаһандандыру
pıtsa	пицца
repatrıasıalaý	репатриациялау
kondısıonalızm	кондиционализм
tvorchestvolyq	творчестволық
fagosıtelotárizdiler	фагоцителлотәрізділер
gastróldyq	гастрольдық
atol	атолл
ıańylady	иаңылады
prosesin	процесін
choqym-choqym	чоқым-чоқым
ınvarıantty	инвариантты
hárneche	һәрнече
jırochekter	жирочектер
rasıon	рацион
ıúkúnch	иүкүнч
bakalavrıat	бакалавриат
lıngvıstiń	лингвистің
desorbsıa	десорбция
armánsha	армянша
ıarlyǵ	иарлығ
zaharly	заһарлы
asbessement	асбестцемент
ıarshym	иаршым
dıagenez	диагенез
estakadalar	эстакадалар
iiiımaı	іііимай
trıseksıasy	трисекциясы
proporsıonal	пропорционал
hárchand	һәрчанд
jahandaný	жаһандану
modýlderdiń	модульдердің
ametısti	аметисті
pasıfıs	пацифист
alapesteı	алапестеи
modýldeý	модульдеу
karteldik	картельдік
proeksıa	проекция
soıara	сойара
plasına	пластина
aeronavt	аэронавт
monosıkl	моноцикл
statıstiń	статистің
akredıtıv	аккредитив
bekerel	беккерель
forfeıtıń	форфейтинг
sensasıa	сенсация
hat-ýl-lahı	һат-ул-лаһи
geshtalterapıa	гештальтерапия
elektrbalqytqysh	электрбалқытқыш
aleıasy	аллеясы
poves	повесть
doısaldákeı	доисалдәкей
aksentsiz	акцентсіз
armreslıń	армресслинг
ratıfıkasıala	ратификацияла
týrıstiń	туристің
ashshy	ащы
taǵbıa	тағбиа
sýspenzoıd	суспензоид
chegegóz	чегегөз
ahlap-úhle	аһлап-үһле
evolúsıonızm	эволюционизм
brıllıanttaı	бриллианттай
babýın	бабуин
táháııýz	тәхәййуз
saýirla	сауьірла
konstrýksıalary	конструкциялары
aıdahar	айдаһар
ıllúvıılik	иллювийлік
bıhısht	биһишт
endemık	эндемик
fólklorıstik	фольклористік
qaharman	қаһарман
aktıvısti	активисті
ashinalyq	ашьіналық
revkasıa	ревкация
epostyq	эпостық
romanıstiń	романистің
quziret	құзырет
lústra	люстра
mınıým	миниум
mehanızasıalatý	механизациялату
shaharstan	шаһарстан
forpos	форпост
ıntellektýaldi	интеллектуальді
brıjı	бриджи
dıreksıa	дирекция
skýlptýra	скульптура
jahıdy	жаһиды
ólkadaı	ёлкадай
adaptasıalaný	адаптациялану
lúmınesenttik	люминесценттік
gıpopotam	гиппопотам
qurylymdyq-metalogendik	құрылымдық-металлогендік
sıvılızasıaly	цивилизациялы
anhımanı	анһимани
logısızm	логицизм
aksentýasıalmiýy	акцентуациялміуы
kúrı	кюрий
ınterosepsıa	интероцепция
avıator	авиатор
aláns	альянс
dıatermıa	диатермия
mıazma	миазма
optımıs	оптимист
sohánchın	сохәнчин
fortısımo	фортиссимо
konsıgnasıa	консигнация
kondensasıalanǵan	конденсацияланған
dıstrıbútor	дистрибьютор
dıakýzıa	диакузия
kálkalan	калькалан
mıkromarketıń	микромаркетинг
nýllıfıkasıa	нуллификация
nekropol	некрополь
desıbel	децибел
aeronavıǵaqıa	аэронавиғақия
brıllıant	бриллиант
akalkýlıa	акалькулия
slesar	слесарь
revokasıa	ревокация
gıdroenergetıka	гидроэнергетика
rýhanı-moraldyq	рухани-моральдық
gólfetrım	гольфетрим
melıorasıa	мелиорация
afelıı	афелии
ıapjan	иапжан
razrádtelý	разрядталу
koksıdıa	кокцидия
kompozısıalyq	композициялық
ShQMÝ	ШҚМУ
emıssarıı	эмиссарий
reıtıńi	рейтингі
sújetsiz	сюжетсіз
poezıasynyń	поэзиясының
datqoı	датқои
rentabeldik	рентабельдік
beletrıstiń	беллетристің
aeraqıa	аэрақия
trepanasıa	трепанация
dıatrema	диатрема
galı	галлий
rezervısti	резервисті
manıfesti	манифесті
ınsest	инцест
ınspeksıa	инспекция
alo	алло
mıstıfıkasıalaý	мистификациялау
ıalyndy	иалынды
mıýanyń	миуаның
mesenattyq	меценаттық
ekvıvalent	эквивалент
marganes	марганец
salúkı	салюки
barıglosıa	бариглоссия
fashıseri	фашистері
kanalızasıa	канализация
avtomobılder	автомобильдер
ıngalásıalaý	ингаляциялау
dýpleks-prosess	дуплекс-процесс
ekzıstensıa	экзистенция
ǵalıakpar	ғалиакпар
mach-týrnır	матч-турнир
eksteroreseptorlar	экстерорецепторлар
knázdik	князьдық
gegelshilder	гегельшілдер
gastroenterokolıt	гастроэнтероколит
jahandy	жаһанды
monarhısti	монархисті
opıstoseldi	опистоцельді
ınvarıant	инвариант
elementter	элементтер
emıljan	эмилжан
ıistik	йістік
vedimis	ведомость
qamlanchý	қамланчу
úńǵyl-pgúsǵyl	үңғыл-пгүцғыл
quıaqny	құйақны
asbesoz	асбестоз
ekvıvalenttik	эквиваленттік
ıarashmady	иарашмады
etnosentrızm	этноцентризм
aeronamıa	аэронамия
pıanıster	пианистер
slaván	славян
germetızasıalan	герметизациялан
deklarasıa	декларация
tahaýı	тахауи
chadyra	чадыра
modeldi	модельді
trıatlon	триатлон
kúchedi	күчеді
TSh	ТШ
allahýákbar	аллаһуәкбар
avtosement	автоцемент
varıaqıa	вариақия
glotogenıalyq	глоттогениялық
qylshi	қыльші
gafel	гафель
ıodtandyryl	йодтандырыл
qabı-lııat	қаби-лииат
demobılızasıalaý	демобилизациялау
melıorasıalyq	мелиорациялық
mıgrasıa	миграция
dızeldi	дизельді
mýtasıalaný	мутациялану
traheıt	трахеит
týrıs	турист
rasıonalıstiń	рационалистің
ıláhım	илаһим
aparatýra	аппаратура
metalofon	металлофон
anderaıterleriniń	андеррайтерлерінің
aerodınamıkalyq	аэродинамикалық
elegıalyq	элегиялық
balondy	баллонды
nakkadaka-ıppon-ken	наккадака-иппон-кэн
ıntereri	интерьері
lısenzıasy	лицензиясы
ampýtasıa	ампутация
cherbaýyr	чербауыр
dılúsıasy	дилюциясы
replıkasıasy	репликациясы
fraksıa	фракция
frahtovatel	фрахтователь
bahadar	баһадар
mınıtrek	минитрэк
dıfýzıa	диффузия
konfesıaaralyq	конфессияаралық
aglútınatsıa	аглютинация
galvanokaýstıka	гальванокаустика
deflásıa	дефляция
dıalektologıa	диалектология
ınstıtýsıonalızasıa	институционализация
plazmolem	плазмолемма
adektıvti	адъективті
antısıklondy	антициклонды
elementar	элементар
tısa	тисса
bıllahı	биллаһи
borsovkalar	борцовкалар
jáshtıkah	жәштикаһ
ımıji	имиджі
ahdanııat	ахданийат
kardıoıda	кардиоида
sosıaldyq	социалдық
ıańqýlady	иаңқулады
afınasıa	аффинация
ınternasıonalızasıa	интернационализация
álmandın	альмандин
bálzamda	бальзамда
hansý	ханьсу
barchasyǵa	барчасыға
makroasembler	макроассемблер
ınternasıonalshy	интернационалшы
eksplozıalyq	эксплозиялық
dýalıstiń	дуалистің
apolon	аполлон
balastar	баластар
eklampsıa	эклампсия
popýlásıa	популяция
kontınýaldylyq	континуальдылық
kuqiǵy	кұқьіғы
premera	премьера
keskinińdiıtjalaǵyr	кескініңдіитжалағыр
rekvızısıalaý	реквизициялау
emansıpasıasy	эмансипациясы
astrodachık	астродатчик
shlápaly	шляпалы
profesorlyq-	профессорлық-
mýnısıpıaldyq	муниципиалдық
ensıklopedıalyq	энциклопедиялық
qachaly	қачалы
fahana	фаһана
akomodattaný	аккомодаттану
makroekonomıkalyq	макроэкономикалық
mobılızasıa	мобилизация
ıaryldy	иарылды
mınıatúralyq	миниатюралық
mıkroasambler	микроассамблер
charter	чартер
goasın	гоацин
elementke	элементке
nestorıanshyldyq	несторианшылдық
glotogenıa	глоттогения
avtoınspektor	автоинспектор
avıatozańdandyrý	авиатозаңдандыру
telestansıa	телестанция
lenchık	ленчик
ladıa	ладья
sımvolıster	символистер
ıaryndaq	иарындақ
safán	сафьян
komýtasıalanatyn	коммутацияланатын
kolokvıým	коллоквиум
perdıýan	пердиуан
kansellıng	канцеллинг
padshahlar	падшаһлар
assosıatıvtik	ассоциативтік
aıaqlaryǵa	айақларыға
gramatıkalan	грамматикалан
tushshy	тұщы
geoantıklınal	геоантиклиналь
emısıa	эмиссия
pálte	пальто
jıp	джип
terarıým	террариум
ıanlyq	ианлық
baptıstiń	баптистің
stolbnák	столбняк
sýbektıvızm	субъективизм
saldar	сальдар
proterozoı	протерозои
búırekchisi	бүйрекчісі
reformısik	реформистік
gýlbıshe	гульбище
aparat	аппарат
manýaldi	мануальді
chaqynda	чақында
kýllıat	куллиат
syqpyı	сықпыи
býlbkıl	бульбкиль
sýbetnıkalyq	субэтникалық
sýlfıdın	сульфидин
dıazoqosylys	диазоқосылыс
bilgeniche	білгеніче
ıarmaq	иармақ
transkrıpsıa	транскрипция
áýendeı	әуендеи
hazııa	хазйиа
haırıń	хайринг
asımılásıalaýshy	ассимиляциялаушы
armosementti	армоцементті
ınkýbasıa	инкубация
konvensıasy	конвенциясы
rasıonal	рационал
vıtáz	витязь
sýbýhııan	субухйиан
rentabeldi	рентабельді
reprezentasıa	репрезентация
korporasıa	корпорация
stıldik	стильдік
manıpýlásıalaý	манипуляциялау
sosıobıologıa	социобиология
modáldy	модальды
ınısıator	инициатор
megagers	мегагерц
gazıfıkasıalaý	газификациялау
ıngalátorıı	ингаляторий
sentımentalıster	сентименталистер
aberasıa	аберрация
ıneksıa	инъекция
últraúlken	ультраүлкен
eksport	экспорт
resenzıala	рецензияла
asosıasıalanýy	ассоциациялануы
sakápker	сакяпкер
pesımıster	пессимистер
sosıogramma	социограмма
ıazuqluǵ	иазұқлұғ
ırasıonalızm	иррационализм
aksentologıa	акцентология
sýbalpilik	субальпілік
ınternasıonalızmder	интернационализмдер
ıaǵlandy	иағланды
fantasty	фантасты
ofıser	офицер
láýhil	ләуһіл
koefısıenttik	коэффициенттік
bychyshdy	бычышды
baıahmet	байахмет
analgezıa	анальгезия
plas	пласт
eksporttyq	экспорттық
parhızgar	парһизгар
panıslamıs	панисламист
teplısa	теплица
rezolúsıa	резолюция
revolúsıoner-demokrat	революционер-демократ
qyrchylý	қырчылу
chettik	четтік
elıpsoıd	эллипсоид
dısertant	диссертант
genosıdtik	геноцидтік
mıneralızasıa	минерализация
evrıtmıa	эвритмия
osılogram	осциллограмма
avantúra	авантюра
antısıentızm	антисциентизм
sensýalıs	сенсуалист
konvergensıa	конвергенция
gravúralaý	гравюралау
aktórdeı	актёрдей
qumcheker	құмчекер
parabelým	парабеллум
demoralızasıa	деморализация
boıshas	бойшац
OShAMQ	ОШАМҚ
cherneý	чернеу
búdjetten	бюджеттен
beıapar	бейапар
dodekaedr	додекаэдр
dýnıadar	дунйадар
mýltımádenıet	мультимәдениет
eksportshy	экспортшы
sırkýlár	циркуляр
obektıvti	обьективті
aerodrom	аэродром
gıaloplazma	гиалоплазма
bálláhı	бәлләһи
taǵazıat	тағазиат
gıdroızobattar	гидроизобаттар
ıańzatty	иаңзатты
glotologıa	глоттология
ǵınaıat	ғинайат
chazanda	чазанда
saıası-moraldyq	саяси-моральдық
múhlat	мүһләт
gelıasher	гелиашер
ýasııat	уасйиат
alpystń	алпыстьң
barshına	барщина
cheldeý	челдеу
dıftoń	дифтонг
ızvestnák	известняк
rentabeldilik	рентабельділік
skalár	скаляр
dıabetık	диабетик
merıdıandyq	меридиандық
ólkaly	ёлкалы
badán	бадьян
shakaıat	шакайат
nýkıte	нукитэ
separasıalaý	сепарациялау
amonıt	аммонит
leıster	лейцтер
kasasyna	кассасына
esse	эссе
grıgorıan	григориан
ekspedısıa	экспедиция
ekvılıbrısti	эквилибристі
pıadeniń	пиаденің
ırrahım	ирраһим
ShK	ШК
mazhabtary	мазһабтары
ımperıalısik	империалистік
chaq-chúq	чақ-чүқ
byǵitý	бығьіту
anderaıterlik	андеррайтерлік
ShIK	ШИК
transaksıa	трансакция
elektrkardıografıa	электркардиография
qachqan	қачқан
telýr	теллур
sıez	съезд
rekýltıvasıalaý	рекультивациялау
zalbandtar	зальбандтар
konstrýksıalardyń	конструкциялардың
asıstentýra	ассистентура
namahram	намаһрам
annýlásıa	аннуляция
nıgılıster	нигилистер
fatalıstiń	фаталистің
ekskýrsıasy	экскурсиясы
sadıs	садист
samadııat	самадйиат
mıelosıt	миелоцит
antıkorozıalyq	антикоррозиялық
ıarsytty	иарсытты
sholastyń	схоластың
áýeıilený	әуеиілену
AÓİSShK	АӨІСШК
avantúrısti	авантюристі
selpo	сельпо
radıolokasıa	радиолокация
ekonomıa	экономия
avıaqurylys	авиақұрылыс
fılatelıster	филателистер
mıkrofılm	микрофильм
lokomobıl	локомобиль
aqtachy	ақтачы
ıývenıldi	ювенильді
asosıasıa	ассоциация
pýblısıster	публицистер
poezıalyq	поэзиялық
anapes	анапест
aksentter	акценттер
rasıonalda	рационалда
beıformaldy	бейформальды
emıgrant	эмигрант
bınakah	бинакаһ
dachıgi	датчигі
akkresıa	аккреция
medısınasy	медицинасы
lısenzıasyz	лицензиясыз
emerdjenttik	эмердженттік
aeroǵarysh	аэроғарыш
sardelka	сарделька
beıneeffekt	бейнеэффект
ınflúasıalyq	инфлюациялық
almaýı	алмауи
menshevıkter	меньшевиктер
motosıklsh	мотоциклш
gravúrala	гравюрала
sıtýasıa	ситуация
cheremıs	черемис
apart-otel	апарт-отель
ıntýıtıvızm	интуитивизм
snarád	снаряд
jdahat	ждаһат
áýesqoı	әуесқои
ShOZ	ШОЗ
fılokartısti	филокартисті
ısrahıl	исраһил
sıtatshyldyq	цитатшылдық
abattyq	аббаттық
machbol	матчбол
ıapshurdy	иапшұрды
rasıonalızasıalaý	рационализациялау
moraldyq	моральдық
daıaǵatshy	дайағатшы
baqaıaq	бақайақ
devıanttyq	девианттық
kartıńıst	картингист
generalısımýstyq	генералиссимустық
aptekar	аптекарь
rıznısa	ризница
slótshi	слётші
bıhraq	биһрақ
akordeon	аккордеон
quıutty	құиұтты
regenerasıa	регенерация
áshekeıletý	әшекеилету
jaýharlaý	жауһарлау
bısepsi	бицепсі
razrádty	разрядты
áıel-erkek	әиел-еркек
radısti	радисті
motosıklet	мотоциклет
ábtehı	әбтеһи
klasıkalyq	классикалық
doırashy	доирашы
sháhıdtiń	шәһидтің
leıborıstiń	лейбористің
sıatyǵa	сиатыға
dárgahyna	дәргаһына
lısenzıalaý	лицензиялау
kavalerıster	кавалеристер
lıofılızasıa	лиофилизация
mamolog	маммолог
sosıalızasıalap	социализациялап
magıstraldi	магистральді
ıamaldy	иамалды
sanasıa	санация
yıyndy	ыиынды
demarkasıa	демаркация
ımıj	имидж
sýperkompúter	суперкомпьютер
túıamýnıt	тюямунит
lansetnıkter	ланцетниктер
ındýksıalyq	индукциялық
jahanǵa	жаһанға
dárkáh	дәркәһ
renesanstyq	ренессанстық
jahandas	жаһандас
assosıatıvti	ассоциативті
ınovasıalardy	инновацияларды
aerostat	аэростат
velárlaný	велярлану
rekapıtýlásıa	рекапитуляция
hıdaıat	һидаят
hýqqaan	һуққаан
ınterıadsylyq	интериадцылық
sekúrıtılendirý	секьюритилендіру
chyraǵymyz	чырағымыз
múttáhám	мүттәһәм
sýlfoqyshqyldar	сульфоқышқылдар
vıolonchel	виолончель
ıaýyqdaǵy	иауықдағы
geterosıkldi	гетероциклді
nıgılıstik	нигилистік
formasıa	формация
sepahı	сепаһи
tynshidy	тыншьіды
ıaǵyrlandy	иағырланды
oppózısıa	оппөзиция
mıllıardtyq	миллиардтық
elınızm	эллинизм
sýlfıdtegish	сульфидтегіш
medalón	медальон
orıańqyt	орйаңқыт
búrokrattaný	бюрократтану
pilláıirgishter	пілләиіргіштер
alúmını	алюминий
hasııat	хасийат
abstraksıaly	абстракциялы
muntahı	мұнтаһи
aglomerasıalyq	агломерациялық
ınvarıanttyq	инварианттық
ımpıchmenttik	импичменттік
mashtahat	маштаһат
altynnsh	алтынньщ
qarchyǵa	қарчыға
desorbsıalaý	десорбциялау
golandyq	голландық
morzısti	морзисті
qaharatta	қаһаратта
asosıasıalan	ассоциациялан
dárkoh	даркоһ
kósilsiz	көцілсіз
ovcharka	овчарка
kúltıvasıalyq	культивациялық
ýasaıat	уасайат
holdıń	холдинг
mıllıardshy	миллиардшы
dıfferensıaldaý	дифференциалдау
ıaǵudy	иағұды
kálkýlásıalyq	калькуляциялық
ıtalán	итальян
ıatǵanlarny	иатғанларны
dıasporataný	диаспоратану
endemıa	эндемия
alpenshtok	альпеншток
kınaıa	кинайа
padshahdyn	падшаһдын
vólt-amperlik	вольт-амперлік
jırochek	жирочек
ásirematerıalıstik	әсірематериалистік
maltýsshildik	мальтусшілдік
qıblagah	қиблагаһ
toquzlanchysy	тоқұзланчысы
ekotoksıkologıa	экотоксикология
apendısıt	аппендицит
jentlmendik	джентльмендік
aýispaý	ауьіспау
sapropel	сапропель
sholastık	схоластик
gallıı	галлии
ıodtandyr	йодтандыр
sváshennık	священник
aksıaǵa	акцияға
elektrkoagýlásıa	электркоагуляция
pres-búro	пресс-бюро
chyrǵanaq	чырғанақ
neoserebelým	неоцеребеллум
stılısıka	стилистика
mazhapy	мазһапы
yńyrchaq	ыңырчақ
proteksıonızm	протекционизм
alergodıagnostıka	аллергодиагностика
AShQQQ	АШҚҚҚ
redaksıala	редакцияла
brýsá	брусья
ıastıl	иастил
alergolog	аллерголог
seıtnot	цейтнот
dýalısti	дуалисті
ıntegrasıalan	интеграциялан
merserızasıala	мерсеризацияла
kıkboksıń	кикбоксинг
ıanashyb	ианашыб
prosestiń	процестің
fonetıster	фонетистер
dırıjabl	дирижабль
nagahan	нәгаһан
kapıtalıster	капиталистер
eksponensıaldy	экспоненциалды
ergejeı	ергежеи
eýrovalúta	еуровалюта
konsesıa	концессия
charlab	чарлаб
buhtan	бұһтан
balastyń	балластың
aerozol	аэрозоль
kýbraýııa	кубрауийа
dıfferensıaldy	дифференциалды
gerbasýlfan	гербасульфан
lager	лагерь
shahmardan	шаһмардан
mınımalıster	минималистер
kapúshon	капюшон
búdjetteri	бюджеттері
proses	процесс
peızajısti	пейзажисті
ıdentıfıkasıa	идентификация
terakota	терракота
krester	крестер
gımnazısti	гимназисті
aktıvızasıa	активизация
chabyna	чабына
lápıs	ляпис
ıazyshdy	иазышды
prısep	прицеп
akýzatıv	аккузатив
domısılıant	домицилиант
monokýlárlik	монокулярлық
qurylymdyq-formasıalyq	құрылымдық-формациялық
zarádti	зарядты
baronesa	баронесса
dıfýzıalan	диффузиялан
radıasıaly	радиациялы
ıntýısıonıster	интуиционистер
qoeffısı	қоэффици
chaban-chalaǵaı	чабан-чалағай
TÚKSh	ТҮКШ
fonetıstiń	фонетистің
ashshysyný	ащысыну
metalýrgıasy	металлургиясы
kongres	конгресс
fılıt	филлит
eskapızm	эскапизм
golosen	голоцен
maýlaýııa	маулауийа
jersı	джерси
mýzaııan	музайиан
operasıa	операция
ıaǵylady	иағылады
beıhush	бейһүш
paparassı	папарацци
dıferensıasıa	дифференциация
ımmýnodıagnostıkalyq	иммунодиагностикалық
nahanı	наһани
pecheneg	печенег
dıalız	диализ
margansovka	марганцовка
qulachyny	құлачыны
pasıonarlyq	пассионарлық
ıańylǵan	иаңылған
ıyǵachlandy	иығачланды
monokrıstal	монокристалл
mıtıńileý	митингілеу
dıstansıometr	дистанциометр
chalǵysh	чалғыш
tıamın	тиамин
chapqanda	чапқанда
naqshbandııa	нақшбандийа
ıasadylar	иасадылар
mınıatúra	миниатюра
modernıs	модернист
stılısti	стилисті
patrıarhat	патриархат
ıaýlab	иаулаб
sqemasy	схемасы
ıantar	янтарь
rassolnık	рассольник
ıaıylǵanda	иайылғанда
neoslavánfılder	неославянфилдер
natýralıstiń	натуралистің
ınterpretasıalaný	интерпретациялану
repetısıa	репетиция
daıardaý	дайардау
pýssolandar	пуццоландар
kogerensıa	когеренция
gonosıt	гоноцит
kondısıalaý	кондициялау
ıntegrasıalyq	интеграциялық
neıropsıhıatrıa	нейропсихиатрия
resıdıvıs	рецидивист
ızobýtılasıtat	изобутилацитат
asbesıt	асбестит
elektrondyq	электрондық
strýktýralıs	структуралист
eksplıkasıa	экспликация
gramm-mól	грамм-моль
aksel	аксель
bashchysy	башчысы
bonıfıkasıa	бонификация
beıaıyp	бейайып
leıkopoez	лейкопоэз
orfogram	орфограмма
vasal	вассал
potensıaldyq	потенциалдық
antırevolúsıalyq	антиреволюциялық
konservasıalaý	консервациялау
olımpıadalar	олимпиадалар
asteroıd	астероид
oqytýdaǵi	оқытудағьі
ımýnıteti	иммунитеті
biryshǵaı	бірыщғай
mıllıarder	миллиардер
ashylat	ащылат
muntaha	мұнтаһа
pýnktýasıalyq	пунктуациялық
fıkschúr	фиксчюр
glıserın	глицерин
aktıvıster	активистер
yjdahat	ыждаһат
tasnıat	тасниат
AShM	АШМ
alpy-solpylq	алпы-солпыльқ
padıshah	падишаһ
tradeskansıa	традесканция
tájýıd	тәжуид
álıakpar	әлиакпар
anchoýs	анчоус
ýez	уезд
mehanızasıala	механизацияла
sýksessıa	сукцессия
mehman	меһман
barer	барьер
ıazturdy	иазтұрды
chulǵaný	чұлғану
monarhıstiń	монархистің
chiledi	чіледі
kishiche	кішіче
moıyncha	мойынча
ıafǵanlandy	иафғанланды
koleksıala	коллекцияла
chıanpý	чианпу
materıaldy	материалды
asbahanı	асбаһани
sıentızm-antısıentızm	сциентизм-антисциентизм
ıdarıýısh	идариуиш
jahannamǵa	жаһаннамға
opozısıashyl	оппозицияшыл
baler	баллер
profesýra	профессура
asambleıa	ассамблея
monogram	монограма
últımatým	ультиматум
dısımılásıalan	диссимиляциялан
merıdıany	меридианы
ShRSh	ШРШ
hechnemeden	һечнемеден
ıkosaedr	икосаэдр
jipcheleń	жіпчелең
vakým	вакуум
operasıalarynyń	операцияларының
jahuttaı	жаһұттай
sanchyshyb	санчышыб
chertti	чертті
valútalyq	валюталық
taıanǵan	тайанған
dıafınometr	диафинометр
gıdroızol	гидроизол
globalızasıa	глобализация
taıszı	тайцзи
ahylap-úhile	аһылап-үһіле
býkınıstiń	букинистің
eksperımenti	эксперименті
ekvatorlyq	экваторлық
mehanızasıalaný	механизациялану
translıterasıa	транслитерация
gıpermedıalyq	гипермедиалық
varıaqıala	вариақияла
mılıtarıstik	милитаристік
oportýnıstik	оппортунистік
zahabııa	захабийа
ıaltyraq	иалтырақ
ıjdahattylyq	иждаһаттылық
oblıgasıalary	облигациялары
zelýche	зелуче
obektiniń	объектінің
kókýsınkaı	кёкусинкай
AÓSShK	АӨСШК
ıaǵmady	иағмады
rotasıa	ротация
shahımaran	шаһимаран
shovınıs	шовинист
sýbektileri	субъектілері
mıkroekonomıka	микроэкономика
solıstiń	солистің
karategı	каратэги
ashshylaý	ащылау
ýrbaekologıa	урбаэкология
ichteme	ічтеме
termokars	термокарст
panıslamısti	панисламисті
chal-chabyr	чал-чабыр
sosıalıster	социалистер
reaksıalar	реакциялар
sentner	центнер
ınovasıa	инновация
tranzaksıalyq	транзакциялық
gramem	граммема
ımmelman	иммельман
generalısımýs	генералиссимус
muıanshylyq	мұйаншылық
oportýnısti	оппортунисті
bıll-brokerler	билль-брокерлер
konsaltıń	консалтинг
amınaǵacha	аминағача
ıaýrǵan	иаурған
deklorasıasy	деклорациясы
chaqalaq	чақалақ
tushshylandyrý	тұщыландыру
ochaqynyń	очақының
spıráldy	спиральды
chahshaq	чахшақ
kálkalyq	калькалық
mýson	муссон
armosement	армоцемент
bádeýı	бәдеуи
ıýhıbbýnahý	йухиббунаһу
generalızasıa	генерализация
farıad	фәрйад
aeroport	аэропорт
ıazyldy	иазылды
nervúrli	нервюрлі
hárzıa	һәрзия
ıarashub	иарашұб
metaetıka	метаэтика
sıalyq	циялық
optımısti	оптимисті
chyıratpa	чыйратпа
sessıoner	цессионер
personıfıkasıa	персонификация
masnaýı	мәснәуи
kapsýn	капцун
ıý	ию
ıakandoz	иакандоз
dıýanalyq	диуаналық
sııahat	сийахат
manıkúrly	маникюрлы
búıirjúıkeliler	бүйіржүикелілер
adverbıaldan	адвербиалдан
kresti	кресті
konsesıalyq	концессиялық
kazeındi	казеинді
hıjran	һижран
long-pozısıa	лонг-позиция
ınaıat	инайат
qaharlylyq	қаһарлылық
dızrýpsıa	дизрупция
býnchýk	бунчук
epıstolárlyq	эпистолярлық
mılısıa	милиция
epıdemıologıa	эпидемиология
ıapchurdy	иапчұрды
elızıa	элизия
akropol	акрополь
mıeloblastyń	миелобластың
sedımentasıa	седиментация
ıalqdy	иалқды
restavrasıa	реставрация
charuqlady	чарұқлады
karkade	каркадэ
volastonıt	волластонит
neandertal	неандерталь
dezınfeksıalan	дезинфекциялан
monokl	монокль
dempıńilik	демпингілік
manıpýlásıa	манипуляция
bızan	бизань
eklektıka	эклектика
levomısıtın	левомицитин
emıgrasıa	эмиграция
sechenov	сеченов
medıabilim	медиабілім
moral	мораль
fotoaparat	фотоаппарат
tıranozavr	тираннозавр
gımnazıs	гимназист
daktıldik	дактильдік
patrúli	патрулі
dempıń	демпинг
blúmıń	блюминг
asfáltty	асфальтты
masnaýıat	маснауиат
sýdıalar	судьялар
kaýchýk	каучук
hámsıa	һәмсия
karerlik	карьерлік
verbalızasıa	вербализация
fasıa	фация
qulqin	құлқьін
elektronıka	электроника
zýrrıat	зурриат
deklarasıalamaý	декларацияламау
emúlgırlený	эмульгирлену
devalvasıalaný	девальвациялану
vıse-prezıdent	вице-президент
asbestiń	асбестің
modýlder	модульдер
gıadtar	гиадтар
semályq	семьялық
haftým	һафтум
májilisqat	мәжілісхат
chálkemdeý	чәлкемдеу
gýhgýh	гуһгуһ
týǵıan	туғйан
dekolte	декольте
jahıtshildik	жаһитшілдік
ıshshaı-aı	ищай-ай
máńzisin	мяңзісін
búh-búh	бүһ-бүһ
monosentrızm	моноцентризм
ıntýısıasy	интуициясы
AQSh	АҚШ
trúk	трюк
apendıkýlárıa	аппендикулярия
monıs	монист
qaharmandaı	қаһармандай
entomolog	энтомолог
sanksıalar	санкциялар
mınıatúrshyldyq	миниатюршылдық
relátıvıstik	релятивистік
valter	вальтер
selmag	сельмаг
emchekden	емчекден
ıllahı	иллаһи
general-adútant	генерал-адъютант
ıntýbasıa	интубация
haýasy	һауасы
panteızm	пантеизм
jýrnalısik	журналистік
shası	шасси
halýatııa	халуатийа
sekýlárızm	секуляризм
fevral	февраль
zaharyn	заһарын
kartıń	картинг
kichikke	кічікке
dıetıfen	диэтифен
brıfıń	брифинг
rekvızısıalan	реквизициялан
výlgarlyq	вульгарлық
ınjınırıńtik	инжинирингтік
rekonstrýksıa	реконструкция
mútahı	мүтаһи
babıt	баббит
ǵazalıat	ғазалиат
operasıalar	операциялар
jıhankezdik	жиһанкездік
reparasıa	репарация
asımılásıalaý	ассимиляциялау
eteraz	этераз
qaharlyraq	қаһарлырақ
evapotranspırasıa	эвапотранспирация
ınteroreseptorlyq	интерорецепторлық
adverbıaldaný	адвербиалдану
búletende	бюллетеньде
ensıklopedıashy	энциклопедияшы
ShMOS	ШМОС
senor	сеньор
korák	коряк
búldozershi	бульдозерші
eýropasentrızm	еуропацентризм
dıfferensıal	дифференциал
chekıs	чекист
admınıstrasıa	администрация
rıýaıt	риуайт
alergologıa	аллергология
elegıstiń	элегистің
chyńratty	чыңратты
modıfıkasıa	модификация
ındıan	индиан
kafelshi	кафельші
sújetsizdik	сюжетсіздік
proporsıaly	пропорциялы
laǵyl-jahut	лағыл-жаһұт
deformasıasy	деформациясы
chesnok	чеснок
hılıazm	хилиазм
anderaıterler	андеррайтерлер
anapestiń	анапестің
akordeonıst	аккордеонист
nahaıatsyz	наһайатсыз
aýksıonshy	аукционшы
ıpodrom	ипподром
trıýmfator	триумфатор
ıllúzıonıst	иллюзионист
medıakeńistik	медиакеңістік
anteıdeı	антеидей
akselerasıa	акселерация
el-ıstıhsan	эл-истихсан
bahadúr	баһадүр
ekskýrsıa	экскурсия
ınterpellásıa	интерпелляция
beıbahra	бейбаһра
týrısti	туристі
aerobıka	аэробика
gerıatrıa	гериатрия
kartofel	картофель
ıaǵushdy	иағұшды
regenerasıalaý	регенерациялау
paıýandaý	пайуандау
bırúza	бирюза
brýselez	бруцеллез
búldog	бульдог
bronhektaz	бронхэктаз
oportýnıs	оппортунист
frontırýıýshaıa	фронтирующая
ıaılaǵ	иайлағ
mıtıńiletý	митингілету
sosıalısik	социалистік
teıtildi	теитілді
chaldrady	чалдрады
akvarıýmshy	аквариумшы
depersonalızasıa	деперсонализация
dezınseksıalyq	дезинсекциялық
ýtopıs	утопист
bronenoses	броненосец
chyqaryń	чықарың
padshahny	падшаһны
aksızdeletin	акцизделетін
kúrıan	күриан
plasılın	пластилин
karate-do	каратэ-до
aljııat	алжийат
beınekonferensıa	бейнеконференция
elementterdi	элементтерді
qychqyra	қычқыра
evfemızm	эвфемизм
ǴTSh	ҒТШ
manıfesasıa	манифестация
tóhmát	төһмәт
trıada	триада
gıalýron	гиалурон
avıakompanıa	авиакомпания
potensıal	потенциал
kraspısa	краспица
ıapuldy	иапұлды
adektıvten	адъективтен
monopolıstiń	монополистің
hasteloı	хастеллой
FShShSh	ФШШШ
chylaýjyn	чылаужын
ashshylaýyt	ащылауыт
notıfıkasıa	нотификация
baseın	бассейн
ıshtıha	иштиһа
geıdelberg	гейдельберг
máshhúr-júsip	мәшһүр-жүсіп
alveola	альвеола
krımınalıstik	криминалистік
tálk	тальк
sanksıa	санкция
okýlıster	окулистер
kabeldi	кабельді
bezinch	безінч
ekstrapolásıa	экстраполяция
qıatrlandyrý	қиатрландыру
pavılon	павильон
sındıkalısti	синдикалисті
lúk	люк
evakýasıalaný	эвакуациялану
ıýda-qıý	июда-қию
kelgúnche	келгүнче
jahankesh	жаһанкеш
chımaı-chytpyryq	чимай-чытпырық
mebel	мебель
chekısti	чекисті
chımaldaý	чималдау
aeroádis	аэроәдіс
gımnazıska	гимназистка
malma	мальма
quchushdy	құчұшды
razrádshi	разрядшы
dıatermokoagýlásıa	диатермокоагуляция
kýahayq	куаһаық
ıatmaı	иатмай
natýralıster	натуралистер
chyǵyrlldy	чығырллды
resenzıa	рецензия
kodıfıkasıalaný	кодификациялану
súıinchi	сүйінчі
moh-mohyla	моһ-моһыла
fatalıster	фаталистер
laýegram	лауэграмма
solushdy	солұщды
mıgren	мигрень
atraksıon	аттракцион
pýblısısti	публицисті
stansıasy	станциясы
kúlmınasıa	кульминация
redaqsıa	редақция
ıalǵandurdy	иалғандұрды
terorızm	терроризм
rejısýralyq	режиссуралық
aıaqynyń	айақының
gólf	гольф
gantel	гантель
kapýsınder	капуциндер
chıngal	чингал
rekta-veksel	ректа-вексель
abberasıasy	абберациясы
forpostyń	форпостың
ılúmınasıa	иллюминация
telekonferensıa	телеконференция
plash-palatka	плащ-палатка
lúktik	люктік
dýnııa	дунйиа
banderól	бандероль
chıratpa	чиратпа
búdjetterdiń	бюджеттердің
datagram	датаграмма
denıtrıfıkasıa	денитрификация
tezovrasıasy	тезоврациясы
amálgamalaý	амальгамалау
anýıtet	аннуитет
fýnksıasy	функциясы
quıaqly	құйақлы
aıdaharlyq	айдаһарлық
konvensıa	конвенция
baseıni	бассейні
transmısıa	трансмиссия
ál-mahdı	әл-маһди
oktábr	октябрь
denýdasıalyq	денудациялық
eksternat	экстернат
glotogenez	глоттогенез
gýslár	гусляр
elchileshtiler	елчілештілер
QR SJShİA	ҚР СЖШІА
barıkadala	баррикадала
zıarat	зиарат
UQSh	ҰҚШ
ındýksıalaý	индукциялау
sýblımasıa	сублимация
ıabylyb	иабылыб
hqaqlandy	һқақланды
algologıa	альгология
prınsıptilik	принциптілік
atestattaý	аттестаттау
vakýmmetrıa	вакуумметрия
devalvasıa	девальвация
beıýaqyt	бейуақыт
kapsúl-denotator	капсюль-денотатор
shınshıla	шиншилла
amınoplastyń	аминопластың
demobılızasıalyq	демобилизациялық
ashshylatý	ащылату
gachetıt	гачетит
balon	баллон
besıar	бесиар
polústeý	полюстеу
k-matrısalyq	к-матрицалық
apelsın	апельсин
blok-sqema	блок-схема
gorelef	горельеф
medısınalyq-pedagogtik	медициналық-педагогтік
býdılnık	будильник
jadeıt	жадеит
metalogenıa	металлогения
kalseks	кальцекс
karerany	карьераны
denasıonolızasıa	денационолизация
qamchylab	қамчылаб
charlaý	чарлау
sýbordınasıa	субординация
elektr	электр
ırrıgasıa	ирригация
rasıonalızm	рационализм
ıahýdı	яһуди
mahıs	махист
dórhaı	дөрһай
ıarady	иарады
jahalat	жәһәләт
radıolokasıalaý	радиолокациялау
pozısıasy	позициясы
mobılızasıalaý	мобилизациялау
mıkroprosesor	микропроцессор
sábıdeı	сәбидеи
delımıtasıalaý	делимитациялау
promýlgasıa	промульгация
gıdrolokasıa	гидролокация
jaýharly	жауһарлы
shasyrqaý	шацырқау
dárgahynan	дәргаһынан
kalsefob	кальцефоб
mobılızasıalan	мобилизациялан
steroıdty	стероидты
madár	мадьяр
leıborıs	лейборист
sıonıstiń	сионистің
tuhmat	тұһмат
beshamel	бешамель
ólkasyz	ёлкасыз
konvertasıalaý	конвертациялау
ımpúlster	импульстер
bıoenergetıka	биоэнергетика
gılozoızm	гилозоизм
urǵuchy	ұрғұчы
gorızontal	горизонталь
oportýnıstiń	оппортунистің
varıasıalaný	вариациялану
charttar	чарттар
búvet	бювет
etnopsıhologıa	этнопсихология
akvarel	акварель
syıaqy	сыйақы
esqatologıa	эсхатология
kavıtasıa	кавитация
yhtıar	ыхтиар
áchi-tushy	әтчі-тұщы
tútor	тьютор
ajdahadaı	аждаһадай
kabelder	кабельдер
chaharaına	чаһарайна
chaǵylý	чағылу
ásireıslamshyl	әсіреисламшыл
asımılásıala	ассимиляцияла
akkomodasıa	аккомодация
ıafsady	иафсады
akordty	аккордты
haıbat	һайбат
kónkımen	конькимен
valıým	валиум
galúsınasıalyq	галлюцинациялық
ıalǵuz	иалғұз
ShJJ	ШЖЖ
kúmirah	күміраһ
reaksıasy	реакциясы
aýksıondyq	аукциондық
bıologıcheskaıa	биологическая
ımbesıldik	имбецильдік
ıýbylady	иубылады
mıllıardtaı	миллиардтай
dúbel	дюбель
qychylady	қычылады
alvekokoz	альвекоккоз
charýaq	чаруақ
noktúrn	ноктюрн
materıaldary	материалдары
krıstıan	кристиан
matrýchke	матручке
chyljyraý	чылжырау
glosematıka	глоссематика
taıańu	тайаңұ
uıatty	ұиатты
ShYU	ШЫҰ
ınternasıonaldaý	интернационалдау
kanoeshy	каноэшы
dıateksıs	диатексис
kálkýlásıasy	калькуляциясы
komensalızm	комменсализм
resıdıvısti	рецидивисті
lústrasıa	люстрация
kapıllárlyq	капиллярлық
churqyltaı	чұрқылтай
kadrıl	кадриль
konstatasıa	констатация
revolúsıonerlik	революционерлік
pýrısti	пуристі
súıúnchi	сүйүнчі
termokarstar	термокарстар
sıtolog	цитолог
bemól	бемоль
masqara	масхара
býl-fınısh	буль-финиш
dıspecherlik	диспетчерлік
pıanıno	пианино
reıtıń	рейтинг
koleksıa	коллекция
abolısıa	аболиция
chekildýik	чекілдуік
karer	карьер
hechnámerse	һечнәмерсе
plasebo-effekt	плацебо-эффект
formasıalyq	формациялық
mıllıard	миллиард
dıalektıkasy	диалектикасы
tenısshi	теннисші
alfenol	альфенол
beletrıster	беллетристер
hýfııat	хуфийат
proteın	протеин
sıstıt	цистит
abýdııt	абудйит
múltıplıkasıa	мультипликация
dıalogıaly	диалогиялы
ıaılady	иайлады
ınterpolásıalyq	интерполяциялық
ShTOQ	ШТОҚ
pýdıń	пудинг
phesol	пхэсоль
refraksıa	рефракция
trıatlonshy	триатлоншы
fotoobektıv	фотообъектив
álternat	альтернат
medıateka	медиатека
ıalfatty	иалфатты
ıashurǵan	иашұрған
konsentrasıalan	концентрациялан
memorıal	мемориал
kvıtansıa	квитанция
absolútızm	абсолютизм
avtorızasıalandyrý	авторизацияландыру
kardıogramlyq	кардиограммалық
ıhtıqat	иһтиқат
týnelder	туннельдер
jahandanýy	жаһандануы
výlkanızasıala	вулканизацияла
ıadzaǵlyq	иадзағлық
hıqaıat	хиқайат
RJSShM	РЖСШМ
ammonıı	аммонии
etalony	эталоны
chilińgir	чіліңгір
aksept	акцепт
demodýlátor	демодулятор
roıalıs	роялист
aktıvızasıalaý	активизациялау
krımınalıster	криминалистер
ós	ось
alpınıadalar	альпиниадалар
ınklúzıvtilik	инклюзивтілік
kompúterlendirý	компьютерлендіру
ferobalqytý	ферробалқыту
opıstoseld	опистоцельд
mýshahada	мушаһада
ıassaýı	яссауи
kalendarlyq	календарьлық
dýnııaýı	дунйиауи
tup-tushshy	тұп-тұщы
asınýsy	ацинусы
obektıvtik	объективтік
bıosenoz	биоценоз
ýchaske	учаске
quıaslyr	құйаслыр
apelásıa	апелляция
ıandurdy	иандұрды
zarádtaý	зарядтау
zarád	заряд
chyǵarǵa	чығарға
klırıńi	клирингі
aeronomıa	аэрономия
aerograf	аэрограф
mıllıardta	миллиардта
medal	медаль
qysruttshy	қысрұттщы
gravúra	гравюра
ınstansıa	инстанция
shahjıhan	шаһжиһан
prosent	процент
ıdealıs	идеалист
ıahshylyqdyn	иахшылықдын
ıaǵmalandy	иағмаланды
optımıster	оптимистер
bedvıll	бэдвилл
chabyrgah	чабыргах
chekıstiń	чекистің
nú-ıorktiń	нью-йорктің
prosentteı	проценттей
dıasetılen	диацетилен
asfahan	асфаһан
padshahlyqda	падшаһлықда
gabro-dıabaz	габбро-диабаз
flúger	флюгер
gvardees	гвардеец
galvanızasıa	гальванизация
dısertasıalardy	диссертацияларды
barmaqche	бармақче
rehlat	реһлат
eksedenti	эксцеденті
charqap	чарқап
bahramand	баһраманд
kasator	кассатор
mehnat	меһнат
bısıar	бисйар
amóba	амеба
zahchın	захчин
haptıek	һәптиек
jaıbaraqattysha	жайбарақаттыща
statá	статья
kvadrıpoldik	квадрйпольдік
neoensefalon	неоэнцефалон
obektıvtilik	объективтілік
krosıng	кроссинг
klassıfıkasıala	классификацияла
adıantým	адиантум
kalsefıl	кальцефил
marsııa	марсйиа
aerofototúsirim	аэрофототүсірім
tushshytý	тұщыту
gıperınflásıa	гиперинфляция
mýtasıalyq	мутациялық
domısıl	домициль
radıojýrnalısti	радиожурналисті
dıapozıtıv	диапозитив
ıýrbash	иурбаш
radıojýrnalıs	радиожурналист
búshinch	бүшінч
beletrıstıkalyq	беллетристикалық
qorchan	қорчан
sosıalızasıala	социализацияла
ıalfady	иалфады
tilmách	тілмәч
ınsýlt	инсульт
patrıarhaldyq	патриархалдық
klasısızm	классицизм
ólgúnche	өлгүнче
avtodıspecher	автодиспетчер
vıse-gýbernator	вице-губернатор
ımprovızasıa	импровизация
reıtıń-	рейтинг-
mashhýrat	машһурат
jıhazsyz	жиһазсыз
kastelánsha	кастелянша
tatána	татьяна
terasa	терраса
magıstral	магистраль
perforasıa	перфорация
jahıtshilik	жаһитшілік
ınformasıa	информация
sýlfoksıd	сульфоксид
ıapyshdy	иапышды
telýrıdter	теллуридтер
gımnazıstiń	гимназистің
venchýrlyq	венчурлық
bekgraýnd	бэкграунд
mataýajjeh	матауажжеһ
motokoláska	мотоколяска
avıabaılanys	авиабайланыс
sárýır	сәруир
tárbıa	тәрбиа
agroekologıalyq	агроэкологиялық
ıatǵurdy	иатғұрды
qychqyraıyn	қычқырайын
ASShK	АСШК
deformasıalan	деформациялан
federaldy	федеральды
badshah	бадшаһ
gıalındi	гиалинді
lıngvısıkasy	лингвистикасы
qahtylyq	қаһтылық
sanká	санкья
ekvılıbrıster	эквилибристер
chyqqan	чыққан
aksızden	акцизден
mıllıvolt	милливольт
marksıster	марксистер
ınterpolátor	интерполятор
reformısti	реформисті
ıatturdy	иаттұрды
radıýsy	радиусы
ashshyly-tushshyly	ащылы-тұщылы
makroevolúsıa	макроэволюция
chekıster	чекистер
gıperkalsıemıa	гиперкальциемия
alergologıalyq	аллергологиялық
ekú	экю
amfıbrahıı	амфибрахии
ıapýsha	иапуша
aqyıdy	ақыиды
skýlptýralyq	скульптуралық
hajran	һажран
panahı	панаһи
telekonferensıalar	телеконференциялар
dısımılásıalaný	диссимиляциялану
spektákl	спектакль
jasin	жасьін
bıadad	биадад
ajdahasha	аждаһаша
kostúm-shalbar	костюм-шалбар
troleıbýs	троллейбус
tahlıl	таһлил
latıfýndıster	латифундистер
etnografıalyq	этнографиялық
klırıńtik	клирингтік
eskadrılıa	эскадрилья
gospıtáldyq	госпитальдық
qablegah	қаблегаһ
kres	крест
eheles	еһелес
mohlaý	моһлау
gelıoenergetıka	гелиоэнергетика
demobılızasıalaný	демобилизациялану
askomısetter	аскомицеттер
defısıt	дефицит
reaksıalyq	реакциялық
tushshyla	тұщыла
sımmental	симменталь
jýrnalıser	журналистер
skrıpach	скрипач
modál	модаль
aktýaldandyrý	актуальдандыру
zarádta	зарядта
alegorlaý	аллегорлау
dúımdeı	дюймдей
mınımalıstiń	минималистің
monomısın	мономицин
ekfrasıs	экфрасис
nıtrıfıkasıa	нитрификация
kartochkasy	карточкасы
bálneologıa	бальнеология
pasıv	пассив
notarıaldyq	нотариалдық
eksproprıasıa	экспроприация
chatylady	чатылады
ıaǵmur	иағмұр
konfabýlásıa	конфабуляция
kalán	кальян
kartogram	картограмма
delúvıı	делювии
ıasylady	иасылады
ınjenerlik-avıasıalyq	инженерлік-авиациялық
ıýán	юань
gaploıd	гаплоид
ıodoform	йодоформ
orfogramdaý	орфограммалау
neıtralızasıa	нейтрализация
dıabaz	диабаз
IAQTTSh	ЯҚТТШ
pırotın	пирротин
modýlásıala	модуляцияла
adúnktýra	адъюнктура
avıazaýyt	авиазауыт
ınkýbasıala	инкубацияла
tórtúnchi	төртүнчі
reıtıńilik	рейтингілік
ınvarıanttylyq	инварианттылық
fantas	фантаст
alveokokoz	альвеококкоз
vegeterıandyq	вегетериандық
plúraldyq	плюралдық
fakúltet	факультет
deprıvasıa	депривация
áldegıd	альдегид
bıhýda	биһуда
galúsınasıa	галлюцинация
avtomobılshi	автомобильші
ıamandy	иаманды
týneldeı	туннельдей
fasıı	фасций
kastodıandyq	кастодиандық
súrealısti	сюрреалисті
varıatıvtilik	вариативтілік
ichkeri	ічкері
ıavrady	иаврады
eksplozıa	эксплозия
ızolátory	изоляторы
kúlchin	күлчін
ekosaıasattaný	экосаясаттану
jıhankez	жиһанкез
sýrǵacha	сурғача
ıntýısıonızm	интуиционизм
peızajıs	пейзажист
seleksıoner	селекционер
ansámbl	ансамбль
avıakonstrýktor	авиаконструктор
jadily	жадьілы
ıerks-dodson	йеркс-додсон
avıamodelızm	авиамоделизм
lıngvısıkalyq	лингвистикалық
paralelepıped	параллелепипед
ýltımo	ультимо
ıntervensıa	интервенция
amortızasıa	амортизация
mıkrosqema	микросхема
prosenti	проценті
jıvopıs	живопись
adútant	адъютант
ıonızasıalyq	ионизациялық
antısıopatıa	антициопатия
aýdarystiryp-tóńkeristirý	аударыстьірып-төңкерістіру
absenteızm	абсентеизм
dúımdik	дюймдік
ShUKD	ШҰКД
slavánofıldik	славянофильдік
gondoler	гондольер
úhileý	үһілеу
rekýltıvasıa	рекультивация
hadııý	һадийу
ımmobılızasıalanýy	иммобилизациялануы
kecher	кетчер
medenchi	меденчі
ıaprytty	иапрытты
volúntatıvtik	волюнтативтік
ashshyly	ащылы
sıtologıalyq	цитологиялық
ıntrospeksıa	интроспекция
výlgarızm	вульгаризм
broneboıshık	бронебойщик
zarádtan	зарядтан
radıoelektronıka	радиоэлектроника
ıturdy	йтұрды
krestiń	крестің
dıýanadaı	диуанадай
kónkıdi	конькиді
asbesi	асбесті
ekologıalandyrý	экологияландыру
termoelektrlik	термоэлектрлік
ashshy-tushshy	ащы-тұщы
reaksıa	реакция
pasıonar	пассионар
yrhaıt-yrhaıt	ырһайт-ырһайт
monıstiń	монистің
vertıkal	вертикаль
dıalektolog	диалектолог
ınterferensıa	интерференция
shaharǵa	шаһарға
konsentrlen	концентрлен
dıametrli	диаметрлі
paıasy	пайасы
stansıa	станция
gaýhardyń	гауһардың
retrosessıalyq	ретроцессиялық
atǵýchy	атғучы
ekonometrıa	эконометрия
realıs	реалист
ımıtasıalyq	имитациялық
elektrhımıalyq	электрхимиялық
dastmaıam	дастмайам
broshúra	брошюра
ıaqryqan	иақрықан
gıpostıl	гипостиль
karboksıldi	карбоксильді
trıhosıstalar	трихоцисталар
gýlden	гульден
vıolonchelıstiń	виолончелистің
qatiran	қатьіран
gafel-gardel	гафель-гардель
sırkúli	циркулі
amofos	аммофос
ıaryla	иарыла
voler	вольер
ıarmaqlandy	иармақланды
súlfatty	сульфатты
alveokok	альвеококк
ál-jahmııa	әл-жахмийа
grafınıa	графиня
entımema	энтимема
chapaýyl	чапауыл
tetraedr	тетраэдр
ıanyǵa	ианыға
model	модель
korektýralyq	корректуралық
gelıokonsentrator	гелиоконцентратор
fonetısti	фонетисті
tyshdady	тыщдады
vykrúk	выкрюк
komýnaldyq	коммуналдық
dısımılásıa	диссимиляция
dıfraksıasy	дифракциясы
mehanızasıalaý	механизациялау
aláıhıssalam	аләйһиссалам
batǵuncha	батғұнча
chynlyǵy	чынлығы
yhtıaryna	ыхтиарына
aeromobıl	аэромобиль
trenıń	тренинг
gıstıosıt	гистиоцит
ıntervú	интервью
qıýasyn	қиуасын
ıalashy	иалашы
alegorıalyq	аллегориялық
jıhasker	жиһаскер
berılıleý	бериллийлеу
mıgrasıalyq	миграциялық
mýsýrana	муссурана
keıýanasý	кейуанасы
ekvaırıń	эквайринг
resept	рецепт
chohara	чоһара
barǵuncha	барғұнча
amálgama	амальгама
maǵnaýı	мағнауи
prınsıp	принцип
ıntroeksıa	интроекция
redaksıa	редакция
chabyqtaý	чабықтау
yrchytý	ырчыту
komýnıs	коммунист
akvalańıstik	аквалангистік
májilisqana	мәжілісхана
kondensasıalyq	конденсациялық
repatrıasıa	репатриация
dıasporasy	диаспорасы
sýlfırleý	сульфирлеу
dregster	дрэгстер
ımıjeologıa	имиджеология
keıýan	кейуан
medısınalyq-áleýmett	медициналық-әлеуметт
ınstıtýsıonalıst	институционалист
kóbikpolıýretan	көбікполиуретан
sot-ekspertıza	сот-экспертиза
optımıstiń	оптимистің
anapester	анапестер
endotermıalyq	эндотермиялық
labıalızasıa	лабиализация
ırasıonal	иррационал
kros-mádenı	кросс-мәдени
portera	портьера
avıaappat	авиааппат
venzel	вензель
ekspedıtorlyq	экспедиторлық
ıarymlady	иарымлады
profesorlyq	профессорлық
suıaǵu	сұйағұ
avansena	аванцена
qyrchańqy	қырчаңқы
ıngalásıa	ингаляция
effekt	эффект
eksedenttik	эксцеденттік
ıaǵmurshyl	иағмұршыл
dısertasıalyq	диссертациялық
bahane	баһане
monopolızasıala	монополизацияла
beıazamattyq	бейазаматтық
komýnıkasıalary	коммуникациялары
sýbrogasıa	суброгация
epıktik	эпиктік
ıaqasyn	иақасын
manchjýr	маньчжур
krımınalıstiń	криминалистің
okýlıstiń	окулистің
sement	цемент
plastar	пластар
desúdeport	десюдепорт
saqchylarnyń	сақчыларның
chómeleıleý	чөмелейлеу
padshahlyqnyń	падшаһлықның
jýrnalıster	журналистер
feroqorytpa	ферроқорытпа
antısýbstansıalızm	антисубстанциализм
edıkýla	эдикула
konsaltıńtik	консалтингтік
qppqyrý	қьппқыру
maǵaýıa	мағауия
qoıaıyn	қояйын
chaǵyrmaq	чағырмақ
hımmat	һиммәт
fýtýrısti	футуристі
anarhıstiń	анархистің
dressırovshık	дрессировщик
manıfester	манифестер
ıaǵytty	иағытты
týnel	туннель
gıdroekologıa	гидроэкология
ShKAB	ШКАБ
tokar	токарь
hamaıýn	һамайун
dıstrıbýsıa	дистрибуция
annýlásıalaý	аннуляциялау
fılatelısti	филателисті
orangýtań	орангутанг
antenalar	антенналар
epoksıd	эпоксид
saııad	сайиад
materıalıster	материалистер
valqteýshi	вальқтеуші
qhigyrqandy	қһігырқанды
chyrmab	чырмаб
mosıon	моцион
amortızsıalyq	амортизциялық
biteýmúıizdiler	бітеумүиізділер
jahutdas	жаһұтдас
gabrolyq	габбролық
plasty	пласты
aısbaıl	айсбайль
chaharpoıdar	чаһарпойдар
metalýrgıalyq	металлургиялық
shahımardan	шаһимардан
ıllústratıvtik	иллюстративтік
moráktaı	моряктай
ıakshal	иакшал
pýblısısıkalyq	публицистикалық
terıkon	террикон
ıntegrasıa	интеграция
vanadı	ванадий
kardıazol	кардиазол
gabro-sıenıt	габбро-сиенит
protorenesans	проторенессанс
presýha	прессуха
smalta	смальта
epıdemıolog	эпидемиолог
hejırleý	хеджирлеу
jıhazdalý	жиһаздалу
kasırlik	кассирлік
dıfýzıalyq	диффузиялық
artısik	артистік
fraksıasy	фракциясы
evfonıa	эвфония
orlyqchy	орлықчы
chánchár	чәнчәр
as-sıfatııa	ас-сифатийа
halqým	һалқум
akord	аккорд
epılepsıa	эпилепсия
afekt	аффект
shaharbaı	шаһарбай
beıajal	бейажал
tendensıa	тенденция
polımetal	полиметалл
gıdroelevator	гидроэлеватор
lákros	лякросс
rafınasıa	рафинация
goland	голланд
stasıonar	стационар
keltirı	келтірй
hrıstıandyq	христиандық
TShO	ТШО
notarıýstyń	нотариустың
mıkroprosesorlyq	микропроцессорлық
bıqııas	биқйиас
mıosen	миоцен
katúsha	катюша
komısıa	комиссия
etnogr	этногр
asbessementtik	асбестцементтік
chelpek	челпек
stenografıster	стенографистер
asfahanı	асфаһани
brússel	брюссел
mılıtarısik	милитаристік
sentábr	сентябрь
sýsildat	сусьілдат
epıherema	эпихерема
emosıalylyq	эмоциялылық
ıalbardy	иалбарды
mıtıń	митинг
roıalıster	роялистер
konfıskasıalaý	конфискациялау
motoestafeta	мотоэстафета
kálkýlásıalaý	калькуляциялау
pendeltúr	пендельтюр
kvıtansıalyq	квитанциялық
ıllúzıa	иллюзия
JShQ	ЖШҚ
gaploıdtik	гаплоидтік
gúljıhan	гүлжиһан
deklarasıalaý	декларациялау
olturǵýchy	олтұрғучы
kondısıasy	кондициясы
ınvestısıalar	инвестициялар
etno-aǵartýshylyq	этно-ағартушылық
bústgalter	бюстгальтер
medıana	медиана
aproksımasıa	аппроксимация
qolchyq	қолчық
sholasty	схоласты
fálákıat	фәләкиат
brýselezdi	бруцеллезді
ınostransevıa	иностранцевия
novelalyq	новеллалық
ekletıka	эклетика
obektilik	объектілік
ofshor	оффшор
karerishilik	карьерішілік
dızúnksıa	дизьюнкция
chyqaraly	чықаралы
sekýlárıstik	секуляристік
desımetrlik	дециметрлік
kapúshondy	капюшонды
dıatez	диатез
medısına	медицина
ichlerinde	ічлерінде
jıhazdaýly	жиһаздаулы
kýrschy	курсчы
ınteraksıonızm	интеракционизм
narsıs	нарцисс
-ınovasıalyq	-инновациялық
okýpasıalaný	оккупациялану
modernıstiń	модернистің
chaharıar	чаһарйар
statıster	статистер
legalızasıa	легализация
veloergometr	велоэргометр
áskerı-ekonomıkalyq	әскери-экономикалық
trıýmfaldyq	триумфалдық
sekvoııa	секвойя
machtyq	матчтық
mergeldi	мергельді
analgın	анальгин
kúnahı	күнәһи
rekombınasıa	рекомбинация
matróchke	матрөчке
avıamodeldi	авиамодельді
basha-keshelep	баща-кещелеп
atrıbýsıa	атрибуция
fılokartıs	филокартист
komúnıke	коммюнике
orchýlyqchy	орчулықчы
gıdroıdtar	гидроидтар
ınterlısso	интерлиццо
ıarymy	иарымы
ansabl	ансабль
parashút	парашют
ıarashqandyn	иарашқандын
aýlııa	аулийа
leıborısti	лейбористі
ınternasıonalızm	интернационализм
ıapchundy	иапчұнды
kepıýtsiný	кепиутсіну
aıýandyq	айуандық
flúorografıalyq	флюорографиялық
vertıkaldy	вертикальды
drossel	дроссель
ıaraǵlyǵ	иарағлығ
parashútshi	парашютші
persepsıa	перцепция
shose	шоссе
ıapsady	иапсады
ınfıltrat	инфильтрат
aerodromy	аэродромы
búırekchi	бүйрекчі
IASJTShU	ЯСЖТШҰ
sementti-jańqaly	цементті-жаңқалы
marsab	марьсаб
sosıologıalyq	социологиялық
marksıstiń	марксистің
snarádty	снарядты
górıan	гөриан
ıodbenzol	йодбензол
beıaddıtıvtik	бейаддитивтік
tstarlys	тцтарлыц
kotej	коттедж
reseptor	рецептор
vındsórfer	виндсёрфер
perpendıkýlár	перпендикуляр
ýısalat	уисалат
muhtarıat	мұхтариат
bıaqıbat	биақибат
baptıs	баптист
ıarandy	иаранды
generaladútant	генераладъютант
gıdratasıa	гидратация
pakıaz	пакйаз
charbaq	чарбақ
dıspecher	диспетчер
spermatozoıd	сперматозоид
sınkografıa	цинкография
ıashartty	иашартты
psıhıatrıa	психиатрия
demensıa	деменция
slavánshildik	славяншылдық
menshevızm	меньшевизм
vakým-apparat	вакуум-аппарат
parólderdi	парольдерді
asıkldi	ациклді
ınkasasıa	инкассация
ımbır	имбирь
rentgenogram	рентгенограмма
dıalektıkalyq	диалектикалық
streptosıd	стрептоцид
edýkologıa	эдукология
vekseldik	вексельдік
ansámblder	ансамбльдер
vakýmmetr	вакуумметр
eksperımenttik	эксперименттік
tushshylandyr	тұщыландыр
shmıaıtorsyq	шмиайторсық
frıksıalyq	фрикциялық
mınımalısti	минималисті
monopolızasıalaý	монополизациялау
ıtalándyq	итальяндық
avantúrıs	авантюрист
blank-vaýcher	бланк-ваучер
hanaqah	ханақаһ
sholastar	схоластар
ekonomıstiń	экономистің
gabro-pegmatıt	габбро-пегматит
alkoloıd	алколоид
manıkúrshi	маникюрші
chaptalaý	чапталау
konstıtýsıashylyq	конституцияшылық
chyqmasańyz	чықмасаңыз
karer-ekskavator	карьер-экскаватор
kúnáhar	күнәһар
metalýrg	металлург
boýlıń	боулинг
rezervıster	резервистер
sıpahıgarchılık	сипаһигарчилик
SShI	СШИ
kanon	каньон
bálzamdan	бальзамдан
aalahı	аалаһи
degradasıa	деградация
etıkasy	этикасы
eksperımettikádis	экспериметтікәдіс
dısonans	диссонанс
ınısıatıvaly	инициативалы
chaılaný	чайлану

